meme dangereux kima blida fiparout fi parout	ADV ADJ ADV PROPN _ ADP ADV
salam ya nasse ad3ooo rabi ysagam ahwale l'blade l' blade kbale o mba3ad le football	INTJ INTJ NOUN VERB PROPN VERB NOUN _ DET NOUN ADP CCONJ ADV DET NOUN
cha3b mrid hata f les commantaire ta3 chorouk tsabo ba3dakom o tat3ayro hhhhhhhhhhhhh rabi yahdina o yahdikom	NOUN ADJ ADP ADP DET NOUN ADP PROPN VERB PRON CCONJ VERB INTJ PROPN VERB CCONJ VERB
kadra allah wa machaa faal a3anaka alaah ala baloik	VERB PROPN CCONJ VERB VERB VERB PROPN ADP NOUN
vive bougera enchalah el3ame el 3ame eljaye el jaye fe real madrid	VERB PROPN INTJ _ DET NOUN _ DET ADJ ADP PROPN PROPN
rana jayne ya el 3adian hacha l hrarcha et l oharna	VERB ADJ INTJ DET NOUN ADV DET NOUN CCONJ DET NOUN
hada mabka hata les noir yetmasakhro b les algerien 3ayb welah lol	PRON ADJ ADP DET ADJ VERB ADP DET NOUN NOUN INTJ INTJ
M3a boumediene jusqu'a jusqu' a la mort	ADP PROPN _ ADP ADP DET NOUN
hajat rabi toujour nkolo marahba biha malgrè c'et c' et dure de vivre cette situation mais ça passe car c'èt c' èt luis qui donne et il reprend il faut le remerçi tjr mais dharbat èl3abd èl 3abd hiya li tajrah ???? que dieu soit avec vous ghaza !!! salutation	NOUN PROPN ADV VERB INTJ PRON ADP _ PRON VERB ADJ ADP VERB DET NOUN CCONJ PRON VERB CCONJ _ PRON VERB PRON PRON VERB CCONJ PRON VERB PRON VERB PRON VERB ADV CCONJ NOUN _ DET NOUN PRON PRON VERB PUNCT PRON PROPN VERB ADP PRON PROPN PUNCT NOUN
vive beladi walah yahfede wlade beladi o rbi m3akom o nchalah masorin	VERB NOUN INTJ VERB NOUN NOUN CCONJ PROPN PRON CCONJ INTJ ADJ
Kouli win la vérité	VERB ADV DET NOUN
123 rana m3ak ya ss3dan vive l'algerie l' algerie	INTJ VERB PRON INTJ PROPN VERB _ DET PROPN
si pour le commentaire numero 46 wa fir3awena di ewtedde e wtedde	VERB ADP DET NOUN NOUN NUM CCONJ PROPN ADP _ DET NOUN
si non hna en retard nesshakou 4g 4 g 3andna les portables w kayen draham khassna el ray !!!!	CCONJ X PRON ADP NOUN VERB _ NUM NOUN PRON DET NOUN CCONJ VERB NOUN VERB DET NOUN PUNCT
sa3dan sayé sa y é c bn fin d contra ha bezaf allah ya3tik el saha waseltna lel l el mondial w chekeltha w ga3 mai ma3lich rabi ykhalik sa fait un gro plaisir min l3abna	PROPN _ PRON PRON VERB VERB ADJ NOUN ADP NOUN INTJ ADV PROPN VERB DET NOUN VERB _ ADP DET NOUN CCONJ VERB CCONJ ADV CCONJ INTJ PROPN VERB PRON VERB DET ADJ NOUN ADV VERB
malkoum m3a9din mn ls marocain	ADV ADJ ADP DET NOUN
rabi m3an	PROPN PRON
Serum , anésthésie , w m3ah srir fe cimetiere	NOUN PUNCT ADJ PUNCT CCONJ PRON NOUN ADP NOUN
J'aimerai J' aimerai bien que les americains seront notre protigeurs allahoma ij3al al amricaines awliyaa lana	_ PRON VERB ADV SCONJ DET NOUN VERB DET ADJ PROPN VERB DET NOUN NOUN PRON
Pourtant ani mehtaj à peu prés trois cent millions	SCONJ PRON ADJ ADP ADV ADV DET NOUN NOUN
nchalah la lagerie cup de monde 2010 chahata nchalah 2014 m3a lalgerie l algerie	INTJ DET PROPN NOUN ADP NOUN NUM PROPN INTJ NUM ADP _ DET PROPN
C’est C’ est trop tard , khatak jaboulna la civiere	_ PRON VERB ADV ADJ PUNCT ADP VERB DET NOUN
o lakher l akher khateb yprofaite m3a al far7a yewakhed tefla	CCONJ _ DET NOUN ADJ VERB ADP DET NOUN VERB NOUN
le phénomène jedid li jana le3wam le 3wam adiya	DET NOUN ADJ PRON VERB _ DET NOUN PRON
naif mssaken mazalhoum yamnou anta talaab m3a les americans	ADJ ADJ VERB VERB PRON VERB ADP DET NOUN
ouffff!!!! 3aiiitt telement jai j ai envi de d\ lokan jat ga3 lbaldan l baldan l3arabiya l 3arabiya dayra kiman hak lokan falstin stakalat bakri vive algerie	INTJ VERB ADV _ PRON VERB NOUN ADP X SCONJ VERB ADJ _ DET NOUN _ DET ADJ VERB ADP PRON SCONJ PROPN VERB ADV VERB PROPN
saha ya benbouzid ya3tik esaha e saha 3a wach derti fina c vrais nous on peu rien te faire mais tkt pas ya y a dieu tu peu pas tèchaper de lui allah la trebhek ya haguar hasbiya allah wa ni3ma alwakil al wakil 3lik	INTJ INTJ PROPN VERB _ DET NOUN ADP PRON VERB PRON VERB ADJ PRON PRON VERB PRON PRON VERB CCONJ VERB ADV _ PRON VERB PROPN PRON VERB ADV VERB ADP PRON PROPN PART VERB INTJ ADJ VERB PROPN CCONJ ADJ _ DET ADJ PRON
123 viva l'algerie l' algerie o tani ya3tikom saha setif cherftouna o tani vive mouloudia o had le 3am chompioné	INTJ VERB _ DET PROPN CCONJ ADV VERB NOUN PROPN VERB CCONJ ADV VERB PROPN CCONJ PRON DET NOUN NOUN
N3agab fe tonobile , am andi les combines	VERB ADP NOUN PUNCT CCONJ PRON DET NOUN
cest c est un homme il mérite un médaille d'or d' or un peuple 3agoun	_ PRON VERB DET NOUN PRON VERB DET NOUN _ ADP NOUN DET NOUN ADJ
ya mouloudia kounou chouia serieux matbahdlounech 3ala khater fe retour li yeghlet ikhaless nchalah teklassiou mlih	INTJ PROPN VERB ADV ADJ VERB ADP NOUN ADP NOUN PRON VERB VERB INTJ VERB ADJ
ya 3anter sayé fatekkk dork c bon khali plastek fiha barak me l $	INTJ PROPN INTJ VERB ADV VERB ADJ VERB NOUN PRON ADV ADP DET NOUN
bouzid khir men belaid et medjani yest7a9 yel3ab m3a l'en l' en	PROPN ADJ ADP PROPN CCONJ PROPN VERB VERB ADP _ DET NOUN
djazair rahet men wakt irhab je crois ke mlih louken jet franca mesta3amretna balak ca seré mieux	PROPN VERB ADP NOUN NOUN PRON VERB SCONJ ADJ SCONJ VERB PROPN NOUN ADV PRON VERB ADJ
mala golhom ani hna dima bien bien bien	ADV VERB PRON ADV ADV ADV ADV ADV
hadi haja meliha ana tsa3adni	PRON NOUN ADJ PRON VERB
dir fibalek fi fibalek rahatt la carriere ta3aket chouff ida wahed mene mas'oulene ( responsables ) yawakfou m3ak apres le retour au bled khater ga3 yabkiw m3a era3i e ra3i ou yadahkou m3a edib e dib	VERB _ ADP NOUN VERB DET NOUN PRON VERB SCONJ NOUN ADP NOUN PUNCT ADJ PUNCT VERB PRON ADP DET NOUN ADP NOUN ADP ADV VERB ADP _ DET NOUN CCONJ VERB ADP _ DET NOUN
Koulchi khdeb koulchi faut , qoulli wiin la vérité	PRON NOUN PRON ADJ PUNCT VERB ADV DET NOUN
rajel omha kelb ki3od ki 3od wa7do yestaf3el faha	NOUN NOUN NOUN _ ADV VERB ADJ VERB PRON
nchalah yehkmou 3lih bel b el mouabed beh may 3awedch chi li ge3d idir fih	INTJ VERB PRON _ ADP DET NOUN ADP PART VERB NOUN PRON ADJ VERB PRON
salam 3alayka ya akhi mohamed lagerie l agerie ci pas pour nous dommage allah yahdi lkoub l koub mas3oulineou mas3ouline ou yarham chouhada li dahaw bache i3ichou ana wata wa ta ou koule jazairiyine hourine bhakhoum b bhakhoum ta3 pitrole wa l gaz kima s3oudiyine hazbouna allah wa ni3mal wakil	INTJ PRON INTJ NOUN PROPN _ DET PROPN VERB ADV ADP PRON INTJ PROPN VERB _ DET NOUN _ ADJ CCONJ VERB NOUN PRON VERB ADP VERB PRON _ CCONJ PRON CCONJ DET NOUN ADJ _ ADP NOUN ADP NOUN CCONJ DET NOUN ADP NOUN VERB PROPN CCONJ NOUN ADJ
merci 3ami boutef	INTJ NOUN PROPN
ki ndimari felatak fe l atak jamais nkhamam 3a linsi7ab l insi7ab	ADV VERB _ ADP DET NOUN ADV VERB ADP _ DET NOUN
????????????? fiha louche had le bomba !!!? et a ce moment ? awahhhhhhhhhhhhhhhhhhhhhh ??? iooo !!!! aderbou 3al che3ir yenssa elkamhhhhhhhhhhhh el kamhhhhhhhhhhhh ?	PUNCT PRON ADJ PRON DET NOUN PUNCT CCONJ ADP DET NOUN PUNCT INTJ PUNCT INTJ PUNCT VERB ADP NOUN VERB _ DET NOUN PUNCT
al khabit iro7 i9abelha tol l le9ibla le 9ibla 9obla ora 9obla 7eta tesba7 3end al 9abla	DET ADJ VERB VERB ADV ADP _ DET NOUN NOUN ADP NOUN ADP VERB ADP DET NOUN
yekhi leghalta le ghalta ta3 lekbar le kbar	INTJ _ DET NOUN ADP _ DET NOUN
vous avez pas honte est vous croyes qu'on qu' on va vous laissez nous donné 4 - 0 chéz vous deja vous allez perdre contre la zambie alor ne vous enflammé pas pffffffff m3ak ya lkhedra l khedra ndirou hala	PRON VERB ADV NOUN CCONJ PRON VERB _ SCONJ PRON VERB PRON VERB PRON VERB NUM PUNCT NUM ADP PRON ADV PRON VERB VERB ADP DET PROPN ADV ADV PRON VERB ADV INTJ PRON INTJ _ DET PROPN VERB NOUN
W elil e lil dima sahrane lhih be chrab f’les f’ les bars	CCONJ _ DET NOUN ADV ADJ ADV ADP NOUN _ ADP DET NOUN
rabi ma3akoum inchallahe ou trbhou rouwanda est surtoud massar el hamdolah hata hna khfna 3lik rabi m3ana contre maroc ya rabi	PROPN PRON INTJ CCONJ VERB PROPN CCONJ ADV PROPN DET INTJ ADP PRON VERB PRON PROPN PRON ADP PROPN INTJ PROPN
reponse au no 7 la presence face a face avec un juif s'est s' est la reconaissance de l'etat l' etat hebreu n3alahom	NOUN ADP NOUN NUM DET NOUN NOUN ADP NOUN ADP DET NOUN _ PRON VERB DET NOUN ADP _ DET NOUN ADJ VERB
non nta ta3leb et hna 3andna fanak !!!!!!	INTJ PRON NOUN CCONJ PRON PRON NOUN PUNCT
Kii nesma3 bel b el coup d'état d' état , kol 7ouma gareta	ADV VERB _ ADP DET NOUN _ ADP NOUN PUNCT DET NOUN ADJ
ouyahya ou yahya walah ma nesmahlek 3and rabi car je travaille pas et G posée un dossier pour avoir une voiture par fasilité lavoiture la voiture coute 40 milions les frée du dossier mon m on couté 14 milions et la taxe cout 7 milions sa fait le tous 21 milions pour avoire 40 milions c normale pour un jeune qui a posée son dossier a \	_ CCONJ PROPN INTJ PART VERB ADP PROPN ADP PRON VERB ADV CCONJ VERB VERB DET NOUN ADP VERB DET NOUN ADP NOUN _ DET NOUN VERB NUM NOUN DET NOUN ADP NOUN _ PRON AUX VERB NUM NOUN CCONJ DET NOUN VERB NUM NOUN PRON VERB DET PRON NUM NOUN ADP VERB NUM NOUN VERB ADJ ADP DET ADJ PRON AUX VERB DET NOUN ADP PUNCT
hadara bla mziyetak imala 3awed rouhak et weli l3aklak	NOUN PART NOUN ADV VERB NOUN CCONJ VERB NOUN
Amine Ya raba El 3alamine	INTJ INTJ PROPN DET NOUN
hda bahdalna fi marakach ou mazal yhki 3la daraja lawla w tanya hda machi modarab 3ando tacharak al fom galak egoulolo al jiniral hda cabran machi jiniral	PRON VERB ADP PROPN CCONJ ADV VERB ADP NOUN ADJ CCONJ ADJ PRON PART ADJ PRON NOUN DET NOUN VERB VERB DET NOUN PRON NOUN PART NOUN
ben yamina 3awwwwwwwwwwwwwwwwwwww3a chourouk il faut t3awnih	PROPN PROPN INTJ PROPN PRON VERB VERB
vive usma wa tahya sidi salam wa rabi i3ayach manadi abrahime fitach el jazayar	VERB PROPN CCONJ VERB PROPN PROPN CCONJ PROPN VERB NOUN PROPN PROPN DET PROPN
nchalah ga3 li 3andeh bac cette annee yadih ya rabii	INTJ ADV ADP PROPN NOUN DET NOUN VERB INTJ PROPN
rana am3akoum ya les verts inchalah 30000 algerien fi stad el kahira ghir rab7ou au zahiwna hada makan	VERB PRON INTJ DET PROPN INTJ NUM NOUN ADP NOUN DET PROPN PART VERB CCONJ VERB PRON NOUN
vive el mouloudia nchaleh ya rabi matahbatch le doyen ne meur jamai ya l3adyen l 3adyen	VERB DET PROPN INTJ INTJ PROPN VERB DET NOUN ADV VERB ADV INTJ _ DET NOUN
ni amtar ni walou hadi darba ta3 l3abd l 3abd machi ta3 rabi	CCONJ NOUN CCONJ PRON PRON NOUN ADP _ DET NOUN PART ADP PROPN
même si c'étais c' étais des térros couvrez les et ne montrer pas 3awratihim salam alikoum	ADV SCONJ _ PRON VERB DET NOUN VERB PRON CCONJ ADV VERB ADV NOUN INTJ PRON
vive jskkkkkkkkkkk hada l3am l 3am lina nchalah	VERB PROPN PRON _ DET NOUN PRON INTJ
hda lahmere la hmere raho la3eb kbire rabi indjeho m3a l'aso l' aso	PRON _ DET NOUN VERB NOUN ADJ PROPN VERB ADP _ DET PROPN
je souhaite la reussite pour notre equipe inchaa lah et l'égypte l' égypte aussi comme ça on finit cette querelle nous sommes tous freres bonne chance à tous rabi 3awenkom	PRON VERB DET NOUN ADP DET NOUN INTJ X CCONJ _ DET PROPN ADV ADP PRON PRON VERB DET NOUN PRON VERB ADJ NOUN ADJ NOUN ADP PRON PROPN VERB
ma3awnoush les jeunes ta3 l blad y3awnous l heraga	VERB DET NOUN ADP DET NOUN VERB DET NOUN
je suis a la recherche d'un d' un logement bela tchipa ou m3aref	PRON VERB ADP DET NOUN _ ADP DET NOUN ADP NOUN CCONJ NOUN
Bessah Be ssah el dem li fi lahmi yweli akhel men lahram la hram	_ ADP NOUN DET NOUN PRON ADP NOUN VERB ADJ ADP _ DET NOUN
khosna chewiya akhebare 3ane fananine wa motribine wa khasatan sur le sport	VERB ADV NOUN ADP NOUN CCONJ NOUN CCONJ ADV ADP DET NOUN
combien 3andak fel f el konte	ADV PRON _ ADP DET NOUN
que dieu soie avc nous m3a had el isslahate	SCONJ PROPN VERB ADP PRON ADP PRON DET NOUN
nichan 3andek el sah sahbi tehya el hamri jusk a la mort weli we li mayabghounech 3lah ?	PROPN PRON DET NOUN NOUN VERB DET PROPN ADP ADP DET NOUN _ CCONJ PRON VERB ADV PUNCT
en plus ka ta3i faha des techniques s3ab	ADP ADV ADV PRON PRON DET NOUN ADJ
ya khoya tarki 3abd allah hasbatlek takwim elmoustamir el moustamir mlih lilna wallah nakdar nkoulek haddek houwa le promble	INTJ NOUN PROPN PROPN PROPN VERB NOUN _ DET ADJ ADJ PRON INTJ VERB VERB PRON PRON DET NOUN
allahouma enssour falestine wj3al w j3al itihad beynana	PROPN VERB PROPN _ CCONJ VERB NOUN PRON
vive ziani we rabi y3ad 3lik el3aine el 3aine nchalah	VERB PROPN CCONJ PROPN VERB PRON _ DET NOUN INTJ
wach hadh lahbal l ahbal ana rani fi canada w nakhdem belhidjab b el hidjab m3a wlad lagwar la gwar ma khafouch 3lihoum mel m el choc en plus edrari e drari yhabouni w leur parents kif kif khafou rabi rani khayfa yab3athlna 3ikab kawm lot	ADV DET _ DET NOUN PRON VERB ADP PROPN CCONJ VERB _ ADP DET NOUN ADP NOUN _ DET NOUN PART VERB PRON _ ADP DET NOUN ADP ADV _ DET NOUN VERB CCONJ DET NOUN ADV ADV VERB PROPN VERB ADJ VERB NOUN NOUN PROPN
vive nahd ya lmsam3i ya lji3ane l ji3ane tghir msfra psk ga3 les jeuns ch3lo les fimigene psk la coupe lina c pas grave sa sera pour la prochaine fois 123 viva l'algerie l' algerie m3ak ya alkhadra al khadra m3aaaaaaaaaaaaaaaaak ya dzayeeeeer	VERB PROPN INTJ PROPN INTJ _ DET ADJ VERB NOUN SCONJ ADJ DET ADJ VERB DET NOUN SCONJ DET NOUN PRON VERB ADV ADJ PRON VERB ADP DET ADJ NOUN INTJ VERB _ DET PROPN PRON INTJ _ DET PROPN PRON INTJ PROPN
Koulchi gdeb koulchi faux	ADV NOUN PRON ADJ
no 2 alah yahdik wen rak 3ayache falmarikhe f almarikhe wala anta hokoma please achourok anchar	INTJ ADP PROPN VERB PRON VERB ADJ _ ADP PROPN CCONJ PRON NOUN INTJ PROPN VERB
halilouzitche tasana fih khadma kbira rah y3awad kollache rabi ykoune m3ah boone kouraj	PROPN VERB PRON NOUN ADJ VERB VERB PRON PROPN VERB PRON ADJ NOUN
Adouma des affaires nkhalihoum le deri sghar	PRON DET NOUN VERB DET NOUN ADJ
la hawla wa la kowata ila b ellah lazem ya3admouh bech yekoun 3ibra limen ya3tabir	PART NOUN CCONJ PART NOUN PART ADP PROPN VERB VERB ADP VERB NOUN PRON VERB
salamou 3alaykoum je suis totalment d'acord d' acord avec le nº 30 llah yahdina ajma3ine	INTJ PRON PRON VERB ADV _ ADP NOUN ADP DET NOUN NUM PROPN VERB ADJ
wa al 3ayaltou rabi yahmik men al 3een	CCONJ ADP NOUN PROPN VERB ADP DET NOUN
Nafsakh el tawba , nhasalha fe la société	VERB DET NOUN PUNCT VERB ADP DET NOUN
wache had tmaskhir goul venger ma khallache saifi yal3ab wallah tmaskhir	PRON PRON NOUN VERB PROPN PART VERB PROPN VERB INTJ NOUN
rabi m3akom ya ridjale	PROPN PRON INTJ NOUN
bonne chance les jeunes w rabi m3akoum nchalah hichem daoud 3andak el djazair w tissemsilt	ADJ INTJ DET ADJ CCONJ PROPN PRON INTJ PROPN PROPN PRON DET PROPN CCONJ PROPN
antouma cha3ab faregh chghoul ga3din que pour le passe temps	PRON NOUN ADJ SCONJ ADJ SCONJ ADP DET NOUN NOUN
ya lakh l akh salah hado ma 3andhom ay 3alaka b islam hado c des juife kifak saha je pense pa la nta algerien w lah yahdik	INTJ _ DET NOUN PROPN PRON PART PRON DET NOUN ADP PROPN PRON VERB DET NOUN PRON NOUN PRON VERB ADV PART PRON NOUN CCONJ PROPN VERB
ces gens la matenfa3ch m3ahom la garde a vue	DET NOUN ADV VERB PRON DET NOUN ADP NOUN
rabi m3akom w hna tani farhouna 123 viva l'algérie l' algérie	PROPN PRON CCONJ PRON ADV VERB INTJ VERB _ DET PROPN
Criminel et tu le resteras toujours Allahoma 3afina fi doniyana wa dinana Amine	ADJ CCONJ PRON PRON VERB ADV PROPN VERB ADP NOUN CCONJ NOUN INTJ
Ki nesma3 bourgeoisi , marcedes mekhou mekrazi , w ana m3a les bus nqâsi	ADV VERB NOUN PUNCT NOUN NOUN ADJ PUNCT CCONJ PRON ADP DET NOUN VERB
ahsan ma fa3alou li ana almaghrib al maghrib yatawafar 3la almala3ib al mala3ib walfanadi9 w al fanadi9 walbounya w al bounya atahtiya machi kima hna	ADJ PRON VERB SCONJ ADP _ DET PROPN VERB ADP _ DET NOUN _ CCONJ DET NOUN _ CCONJ DET NOUN ADJ PART ADP PRON
Kayen li ybi3 , kayen li yghatas , kayen li y9os w kayen li y3as	VERB PRON VERB PUNCT VERB PRON VERB PUNCT VERB PRON VERB CCONJ VERB PRON VERB
é raho nssa rouho gdah 3andou o howa hakame RCD alors sa3id dictateur kima lokhrine l okhrine l'euro l' euro mlih ya sa3id lol	INTJ VERB VERB NOUN ADV PRON CCONJ PRON NOUN PROPN ADV PROPN NOUN ADP _ DET NOUN _ DET NOUN ADJ INTJ PROPN INTJ
Allah ykoun m3aha mskina et celui qui a commis ce crime doit payer	PROPN VERB PRON ADJ CCONJ PRON PRON AUX VERB DET NOUN VERB VERB
eli yakhrab fi bouguera ndir alih gira matmour mon amour o ki ydji ledzair le dzair nroh m3ah ndor ghilas m3ah rana labasse o kolo leila karim ziani mréservé	PRON VERB ADP PROPN VERB PRON PART PROPN DET NOUN CCONJ ADV VERB _ ADP PROPN VERB PRON VERB PROPN PRON VERB ADV CCONJ ADV NOUN PROPN PROPN VERB
vive algeri ou mabrok tal3a o medea merci	VERB PROPN CCONJ INTJ NOUN ADP PROPN INTJ
salam 3likom rabi yhdikom o rabi yjib alkhir al khir yakh thawso 3la aldimokratya al dimokratya hadihya adimokratya a dimokratya ta3 alkrb al krb hhh alah yrahm sdam hcin o m3amr alkdafi o hwari bomdyan	INTJ PRON PROPN VERB CCONJ PROPN VERB _ DET NOUN INTJ VERB ADP _ DET NOUN PRON _ DET NOUN ADP _ DET NOUN INTJ PROPN VERB PROPN PROPN CCONJ PROPN PROPN CCONJ PROPN PROPN
salam 3alaykom rabi fih el khir khona nchalah la france kima jahanam mahabatch tachba3 wa hal min maazid	INTJ PRON NOUN PRON DET NOUN NOUN INTJ DET PROPN ADP NOUN VERB VERB CCONJ ADV ADP ADV
3ajabni mais loukan ykamal bac kima 2010	VERB CCONJ SCONJ VERB NOUN ADP NUM
vive babia hado el jsk rahoum walo ki homa ki sitif m3a babia lala mamat hakda	VERB PROPN PRON DET PROPN VERB PRON ADP PRON ADP PROPN ADP PROPN PART VERB ADV
ànta mrid ya ssamadi chay jib alhmar al hmar 3awed hadj issa kima missi rouh zour wala chouf tbib dawik ya ssamadi	PRON ADJ INTJ ADJ NOUN VERB _ DET NOUN VERB PROPN PROPN ADP PROPN VERB VERB CCONJ VERB NOUN VERB INTJ ADJ
ou nchalah masar tarbah bach nala3bo m3aha ou nchoufo l ballon ta3 asah a sah ou ichouf le monde	CCONJ INTJ PROPN VERB ADP VERB PRON CCONJ VERB DET NOUN ADP _ DET NOUN CCONJ VERB DET NOUN
yerham ldikom fahmona hada sa3dan wach ykon howa tani hab yahkemha 3ohda tania khalina menek ya sa3dan walah rak raiah tkrahelna hiatna bezaf rak kbir ma3andek mattma3	VERB NOUN VERB PRON PROPN PRON VERB PRON ADV VERB VERB NOUN ADJ VERB PRON INTJ PROPN INTJ VERB ADJ VERB NOUN ADV VERB ADJ ADP NOUN
allah la yradj3ak	PROPN PART VERB
ya saadan akol lak fakid chay2 la yo3tih fa ida konta rajol bi ma3na kalima fa tanaha 3an mansibik intha waktek ya cheikhna	INTJ PROPN VERB PRON ADJ NOUN PART VERB PART SCONJ VERB NOUN ADP NOUN NOUN ADV VERB ADP NOUN VERB NOUN INTJ NOUN
rabi m3ak inchallah ne perd pas les espoires et la passience lah yjib chfae; aaaaaaaaaaamine	PROPN PRON INTJ ADV VERB ADV DET NOUN CCONJ DET NOUN PROPN VERB NOUN INTJ
mes phrases man7oucine , ya3miw fel3inine f el 3inine	DET NOUN ADJ PUNCT VERB _ ADP DET NOUN
lah yej3al el 7afd w l7amdoulah li makanche li matou	PRON VERB DET NOUN CCONJ INTJ PRON VERB PRON VERB
hnaya ga3 na3arfo nafto wach yakhroj 3lina	PRON ADV VERB VERB PRON VERB PRON
tgast sa7 w tekhda3t gdah men mara	VERB ADJ CCONJ VERB ADV ADP NOUN
W nweli kif la3bad la 3bad , riche fel f el bled	CCONJ VERB ADP _ DET NOUN PUNCT ADJ _ ADP DET NOUN
nchalah y koun m3ahom rebi nerbho 3 - 0	INTJ PRON VERB PRON PROPN VERB NUM PUNCT NUM
sobhana alah kachi om tahrak banha li man kabdatha hadi tkon marida 3aklyan	VERB PROPN ADV NOUN VERB NOUN PRON ADP NOUN PRON VERB ADJ ADV
Ki nsma3 3al lemra le mra , meskina 7asbouha bagra , maa tekteb maa teqra	ADV VERB ADP _ DET NOUN PUNCT ADJ VERB NOUN PUNCT PART VERB PART VERB
maykhaoufna la bay la baya normale m3a ziani w elhadje el hadje ziyaya	VERB PART NOUN PART NOUN ADV ADP PROPN CCONJ _ DET NOUN PROPN
rabi yansakom w rabi m3akem	PROPN VERB CCONJ PROPN PRON
vive ess vive ess nas kol arfa kifah tel3at lcabba l cabba lnational l national une	VERB PROPN VERB PROPN NOUN DET VERB ADV VERB _ DET PROPN _ ADP ADJ NOUN
Monsieur le Président Allah y3awnek w allah ykadrek 3la laghoual(?????)ta3e la ghoual ( ? ???? ) ta3e tzayer	NOUN DET NOUN PROPN VERB CCONJ PROPN VERB ADP _ DET NOUN PUNCT PUNCT PUNCT PUNCT ADP PROPN
La3nato allahi 3alayhi C'est C' est l'eat l' eat Algerien qui est responsable pour ca	NOUN PROPN PRON _ PRON VERB _ DET NOUN ADJ PRON VERB ADJ ADP PRON
3ayb 3lihom 3azrona elah latbahoum 3am kamen w hna ne9raw et f la f1n ylkharbtoha	NOUN PRON VERB PROPN VERB NOUN ADJ CCONJ PRON VERB CCONJ ADP DET NOUN VERB
la3eb metrabi 3ando akhlak 3alyia inchalah plutard ykoun fi les kipe natonal	NOUN ADJ PRON NOUN ADJ INTJ ADV VERB ADP DET NOUN ADJ
nchallah ya lemouchia tkoun m3ana pask il fo po nfartou f lé jabou la calification	INTJ INTJ PROPN VERB PRON SCONJ PRON VERB ADV VERB ADP PRON VERB DET NOUN
vive boughera contrra 3ala med el wahrani mon papa	VERB PROPN NOUN ADP PROPN DET ADJ DET NOUN
wi w i goulo igoulo l mha mabrouk bantek f jena	_ CCONJ PRON VERB VERB ADP NOUN NOUN NOUN ADP NOUN
ga3 netkalchou machi ghi eljazzira el jazzira w ma3andna mandirou belburau b el burau nta3houm hna w houma gal3ou 3lamna mel les equipes nta3 la coupe du mond	ADV VERB PART ADP _ DET PROPN CCONJ ADP VERB _ ADP DET NOUN PRON PRON CCONJ PRON VERB NOUN ADP DET NOUN ADP DET NOUN ADP NOUN
salam alykoum machi la mouchkil fi chaouchi mouchkil rah fi gazel les l3ab 15 match w marka hata bit	INTJ PRON PART PART NOUN ADP PROPN NOUN VERB ADP PROPN PRON VERB NUM NOUN CCONJ VERB ADV NOUN
merci bcp léquipe l équipe nchalah mondial rah 9ribe lina w madabikom t3ayto al yebdda	INTJ ADV _ DET NOUN INTJ NOUN VERB ADJ PRON CCONJ ADV VERB ADP PROPN
si li jouj alah ghaleb , kan ilbaroud il baroud	NOUN DET NOUN PROPN ADJ PUNCT VERB _ DET NOUN
Feha khadama tokhlos , wahed ma yetkhas	PRON NOUN VERB PUNCT NOUN PART VERB
lemera le mera mahich khedemetha agent de securité mi rabi yekon fi 3awenehom	_ DET NOUN PART NOUN NOUN ADP NOUN CCONJ PROPN VERB ADP NOUN
ih ya elharrachia el harrachia dertou match nul m3a Usma habitou taklou denia hatou rajlikom fel f el ma ybardou had l3am l 3am tahabtou hram 3likom hgartou RCK plasatkom derby m3a bentalha	INTJ INTJ _ DET PROPN VERB NOUN ADJ ADP PROPN VERB VERB NOUN VERB NOUN _ ADP DET NOUN VERB PRON _ DET NOUN VERB ADJ PRON VERB PROPN NOUN NOUN ADP PROPN
lmechkel l mechkel mechi elkhelifa el khelifa lekin li sna3 elkhelifa el khelifa wechkoun we chkoun hadou ? takdar el3adel el 3adel aljezeiria al jezeiria thesebhem ? wella houma yhesbou el3edela el 3edela ? barkawna elhakika el hakika che3b rahou 3arafha	_ DET NOUN PART _ DET NOUN CCONJ PRON VERB _ DET NOUN _ CCONJ ADV PRON PUNCT VERB _ DET NOUN _ DET ADJ VERB PUNCT CCONJ PRON VERB _ DET NOUN PUNCT VERB _ DET NOUN NOUN VERB ADJ
el3am el 3am ejay e jay wahed ma yenjeh puisq rahi ghalta men el wezara wa yethamelha ghir etalamid e talamid merci	_ DET NOUN _ DET ADJ NOUN PART VERB SCONJ VERB NOUN ADP DET NOUN CCONJ VERB PART _ DET NOUN INTJ
w 7arzou l gaz ya jma3a marahch 7aja sehla	CCONJ VERB DET NOUN INTJ NOUN VERB NOUN ADJ
serat b nass l kanet benthom mahmoma igol lhom ntouma rahi tefla mas7oura	VERB ADP NOUN PRON VERB NOUN ADJ VERB PRON PRON VERB NOUN ADJ
W n3awen ma patrie w nfinanci des parties	CCONJ VERB DET NOUN CCONJ VERB DET NOUN
el djazair blad el islam w matou 3aliha lrjal l rjal winkom ya masooline min hadha besah rhadwa kodam allah nhasboukam ahna nmouto wntouma w ntouma jiboulna fi les ordures	DET PROPN NOUN DET NOUN CCONJ VERB PRON _ DET NOUN ADV INTJ NOUN ADP PRON CCONJ ADV ADP PROPN VERB PRON VERB _ CCONJ PRON VERB ADP DET NOUN
rana m3akoum ya wlad el khadra 123 vive algerie far7ouna lah y fara7koum	VERB PRON INTJ NOUN DET PROPN INTJ VERB PROPN VERB PROPN VERB X
ina kaidahona la 3adim astarfirou alah soubhanahou wa ta3ala	SCONJ NOUN VERB ADJ VERB PROPN NOUN CCONJ ADJ
nass chahda we tarikh i3awed nefso	NOUN ADJ CCONJ NOUN VERB NOUN
hhhhhhhhhhhhhhhhhh baggio el 3arab koun yesma3 baggio yecuicidi wlh gla3 hadik queu de cheval nta rajel ya	INTJ PROPN DET NOUN VERB VERB PROPN VERB INTJ VERB PRON NOUN ADP NOUN PRON NOUN INTJ
au lieu zine al3abidine ywakal acha3b a cha3b dyalou yroh yamna3 alhidjab al hidjab yakhi les arabes wellah mayatfahmo	ADP NOUN PROPN PROPN VERB _ DET NOUN PRON VERB VERB _ DET NOUN INTJ DET NOUN INTJ VERB
anta li bidon ya ta3liq rakam 1 mashaalah hadu li yasharfu lblad l blad baraka allahu fik ya sa3doun rabi ywafkak fi koul mashri3ak	PRON PRON ADP INTJ NOUN NOUN NUM INTJ PRON PRON VERB _ DET NOUN VERB PROPN PRON INTJ PROPN PROPN VERB ADP DET NOUN
netmana loukan yel3ab antar yahia w meghni demain inchalah et inchalah vous gagné	PRON SCONJ VERB PROPN PROPN CCONJ PROPN ADV INTJ CCONJ INTJ PRON ADJ
3andna mansouri + saifi c deja beaucoup inchallah la coupe du monde tal3a ntaklou 3la rabi wa 3lik ya sa3dane wa waladek la jounesse	PRON PROPN PUNCT PROPN VERB ADV ADV INTJ DET NOUN ADP NOUN NOUN VERB ADP PROPN CCONJ PRON INTJ PROPN CCONJ NOUN DET NOUN
inchalah hade el3ame el 3ame l'usma l' usma chompioner m3a Hamidi et Anderson	INTJ PRON _ DET NOUN _ DET PROPN NOUN ADP PROPN CCONJ PROPN
el hamdou li llah 3ala hadihi anni3ma an ni3ma	DET NOUN ADP PROPN ADP PRON _ DET NOUN
rabi m3akoum ya les verts we netmano ma ykoun far9 bin eljodod el jodod wa el9odama el 9odama we li rah ya3tina jdid marhba bih	PROPN PRON INTJ DET PROPN CCONJ VERB PART VERB NOUN ADP _ DET ADJ CCONJ _ DET ADJ CCONJ PRON VERB VERB ADJ INTJ PRON
Mes projets am kbar dork nejbedhoum	DET NOUN VERB ADJ ADV VERB
nchalah narbho ya rab w kon m3a les vets ya rab brabi b rabi nchalah	INTJ VERB INTJ PROPN CCONJ VERB ADP DET PROPN INTJ PROPN _ ADP PROPN INTJ
inchallah ncharfoukoum ya 3arab koulouna ma3a lfari9 l fari9 lwatani l watani aljazayri al jazayri	INTJ VERB INTJ NOUN PRON ADP _ DET NOUN _ DET ADJ _ DET ADJ
3ajebeteni hadi	VERB PRON
Mais de quoi je me méle ya khi 3akliya	CCONJ ADP PRON PRON PRON VERB INTJ NOUN NOUN
as-salamo a s-salamo 3alaycom; هداهم الله vraiment c'est c' est trés grave voila l'algerie l algerie exporte le \	_ DET NOUN PRON VERB PROPN ADV _ PRON VERB ADV ADJ INTJ _ DET PROPN VERB PRON PUNCT
hhhh 3lach yghirou a malger tout bladi nebrik chno 3andkom ba3da bach yhasdokoum wallah dahaktini	INTJ ADP VERB INTJ ADP PRON NOUN VERB PRON PRON ADV ADP VERB INTJ VERB
vive USOAamizour et inchalah tal3a inter rigion	VERB PROPN CCONJ INTJ NOUN ADP NOUN
rabi yahdikoom ana koun nelgua wahed yharguni nahrag meme nkoon 3alabali beli rah nmoot hedik lila el mohim nmoot w manbkache hna	PROPN VERB PRON SCONJ VERB NOUN VERB VERB ADV AUX VERB SCONJ AUX VERB PRON NOUN DET ADJ VERB CCONJ VERB ADV
surtout kon na7ki 3li maison de rendez-vous	ADV SCONJ VERB ADP NOUN ADP NOUN
lah y3wnek koya ana gendarme welah w tehkam ma ratiha had bled li d3a 3liha met	PROPN VERB NOUN PRON NOUN INTJ CCONJ VERB PART VERB PRON NOUN PRON VERB PRON VERB
li khatik y3ayik	PRON VERB VERB
va lire 3akidet el noussayriya avant de dire ou de faire des betises enfin rabi yahdina w' yahdik	VERB VERB NOUN DET NOUN ADP ADP VERB CCONJ ADP VERB DET NOUN ADV PROPN VERB CCONJ VERB
dok yadoh lahwayech yakhdem m3ahom	PRON VERB VERB VERB PRON
mazalet 3andi lhayja l hayja ta3 hajouj w majouj	VERB PRON _ DET NOUN ADP PROPN CCONJ PROPN
3alamna lwa7y l wa7y bili rabi houa li ya7di	VERB _ DET NOUN SCONJ PROPN PRON PRON VERB
vive crb nchallah championa had l3am l 3am les vrais ouled cherchell	VERB PROPN INTJ NOUN PRON _ DET NOUN DET ADJ NOUN PROPN
saha vive mouloudia 3lach mdjibounach jeur mlih w nathanaw ya 3amros jibana daham mrsi	INTJ VERB PROPN ADP VERB NOUN ADJ CCONJ VERB INTJ PROPN VERB NOUN INTJ
y al7aja al 7aja alghna al ghna maghadich yanf3ek f la fin yaw salatek w zakatek hia li tanf3ak	INTJ _ DET NOUN _ DET NOUN VERB VERB ADP DET NOUN INTJ NOUN CCONJ NOUN PRON PRON VERB
inshallah tatla3 la7kaya la 7kaya s7i7a 3la khatr dima ykolo hka o yadhhar 3aks dns tt les ie bouteflika	INTJ NOUN _ DET NOUN ADJ ADP NOUN ADV VERB PRON CCONJ VERB ADJ ADP ADJ DET NOUN PROPN
lakther l akther marto koul youm yebahdel faha , yjeb m3aha drari w itayecheha i tayecheha ldar l dar weldaha	_ DET NOUN NOUN DET NOUN VERB PRON PUNCT VERB PRON NOUN CCONJ _ PRON VERB _ DET NOUN NOUN
ya el hamra ya mon amour zahina had el 3am	INTJ DET ADJ INTJ DET NOUN VERB PRON DET NOUN
rabi yahefdek ya si 3atman wellah twahechnak bezaf tahia si mekhlouf el boumbardi	PROPN VERB INTJ NOUN PROPN INTJ VERB ADV VERB NOUN PROPN DET PROPN
Nadkhoulha m3a el dakhlate , w njib el intikhabate	VERB ADP DET NOUN PUNCT CCONJ VERB DET NOUN
a 3ayeniya vive alg	INTJ NOUN VERB PROPN
rak le meilleur entraineur 3arfettou l'equipe l' equipe nationale ya saadane lahi yachafik Bouaza ida kane saadan darha wa ma3ayatlakche walah ma yesthal bach ykoune moudarab de l'equipe l' equipe nationale )))))	VERB DET ADJ NOUN VERB _ DET NOUN ADJ INTJ PROPN PROPN VERB PROPN SCONJ VERB PROPN VERB CCONJ VERB INTJ PART VERB ADP VERB NOUN ADP _ DET NOUN ADJ PUNCT
hanouna man 3ame ou ness tadya3e wakte	VERB ADP NOUN CCONJ NOUN VERB NOUN
2 / hada les coper nhar wahd okher ywili 3ala 3la l'algérie l' algérie c 0 oui	NUM PUNCT PRON DET NOUN NOUN NOUN ADJ VERB NOUN ADP _ DET PROPN VERB NUM INTJ
jil yjib la maniere ta3 achil	NOUN VERB DET NOUN ADP PROPN
vive el marchi nouir ana kont nkhdem fi alger felmarchi f el marchi lokan eyzido eynahiw esizi e sizi ezawali e zawali ey3awen roho chwiya alah galeb makach charikat khlo azwali a zwali yakol elkobz el kobz saha ftorkom	VERB DET NOUN PROPN PRON VERB VERB ADP PROPN _ ADP DET NOUN SCONJ VERB VERB _ DET NOUN _ DET NOUN VERB NOUN ADV PROPN ADJ PART NOUN VERB _ DET NOUN VERB _ DET NOUN NOUN NOUN
cherif elouazani rouh tergod lah la trabhek abou el machakil tayeht elhaouaria el haouaria D2 dert tebehdila fi chlef m3a sidek captene si samir zaoui mazel rak tahder rouh entrainé crb mecheria national 1 une bonne place pour toi kafi	PROPN PROPN VERB VERB PROPN PART VERB NOUN DET NOUN VERB _ DET PROPN NOUN VERB VERB ADP PROPN ADP PROPN NOUN NOUN PROPN PROPN ADV VERB VERB VERB VERB PROPN PROPN ADJ NUM DET ADJ NOUN ADP PRON ADJ
Wa yéff' 3alou el djahilou bi naff'ssihi ma la yéf' 3alou el 3adouwou bi 3adouwihi	CCONJ VERB X DET ADJ ADP NOUN PART PART VERB X DET NOUN ADP NOUN
inchallah ya rabi 3 but amin ya rabi al 3alamin one two tree viva l algerie tahya bladi m3ak y al khadra ndiro hala	INTJ INTJ PROPN DET NOUN INTJ INTJ PROPN DET NOUN INTJ INTJ INTJ VERB DET PROPN VERB NOUN PRON INTJ DET PROPN VERB NOUN
mouto ya les égyptiens rana fi la coupe de monde m3a wladna erajala e rajala les vrais algeriens	VERB INTJ DET NOUN VERB ADP DET NOUN ADP NOUN ADP NOUN _ DET NOUN DET ADJ NOUN
L'téléphone L' téléphone a sonné , presidana a demetionné ; lkhawana l khawana ya3arfouni	_ DET NOUN AUX VERB PUNCT NOUN AUX VERB PUNCT _ DET NOUN VERB
ya akhi rayen t'es t' es qqn de bien macha allah et meme toutes ta famille et ton frere aussi que j'ai j' ai connu et qui été avec moi dans la meme classe natleb rabi ychafik nchallah ou rabi m3ak amine	INTJ NOUN PROPN _ VERB VERB PRON ADP ADV INTJ X CCONJ ADV ADJ DET NOUN CCONJ DET NOUN ADV PRON _ PRON AUX VERB CCONJ PRON VERB ADP PRON ADP DET ADV NOUN VERB PROPN VERB INTJ CCONJ PROPN PRON INTJ
widadi 4 / 1 hade l3ame l 3ame tal3a	PROPN NUM PUNCT NUM PRON _ DET NOUN NOUN
Nahi alf franc men la paie ta3 3abd wahed	VERB DET NOUN ADP DET NOUN ADP NOUN DET
inchallah rabi m3akom vous etes tous algeriens	INTJ PROPN PRON PRON VERB ADJ NOUN
3aso roihkom o mba3ad 3asou les eléves de bac	VERB NOUN CCONJ ADV VERB DET NOUN ADP NOUN
rebi yester le match contre ongola vrai wa3er ghir nhato redjlina fel f el ka3a 3andna equipe bla les attaquans	PROPN VERB DET NOUN ADP PROPN ADJ ADJ PART VERB NOUN _ ADP DET NOUN PRON NOUN PART DET ADJ
allah ikoun m3akom et vive lalgerie l algerie	PROPN VERB PRON CCONJ VERB _ DET PROPN
alache ya tzayer eli andou tzidilou wa el galil yachka w yat3ab	ADV INTJ PROPN PRON PRON VERB CCONJ DET NOUN VERB CCONJ VERB
khawti el blade makhdou3a apès 1979	NOUN DET NOUN ADJ ADP NUM
li mabghanech 3la 3ino haka ndiro ;les algerien des camicaz ga3 ytirou ;mem si 160m 160 m w kader chkah m3a 2m 2 m tir w zid tir ya ziyani w l'algeri l' algeri ga3 m3ak	PRON VERB ADP NOUN PRON VERB DET NOUN DET NOUN ADV VERB ADV SCONJ _ NUM NOUN CCONJ ADJ NOUN ADP _ NUM NOUN VERB CCONJ ADV VERB INTJ PROPN CCONJ _ DET PROPN ADV PRON
pour le N1	ADP DET NOUN
rabi yasterna vraiment les gens sont devenus malades rabi yahdehoum w yba3adhoum 3lina hasbiya allah w ni3ma elwakil el wakil	PROPN VERB ADV DET NOUN VERB VERB ADJ PROPN VERB CCONJ VERB PRON NOUN PROPN CCONJ ADJ _ DET ADJ
ntouma mchi rojala kounou m3ahom fi rebeh w elkhsara el khsara	PRON PART NOUN VERB PRON ADP NOUN CCONJ _ DET NOUN
al 3ar m3a el khain lekber l ekber ta3hom	DET NOUN ADP DET ADJ _ DET ADJ PRON
ay fokna lfog l fog fog liye7kem li ye7kem fougna	INTJ VERB _ ADP NOUN ADP _ PRON VERB PRON
rabbi y3awnak khouya jamel et bienvenue a ton pays l´algerie l´ algerie tahya ljazayer l jazayer saha ftourkoum w shourkoum wled bladi	PROPN VERB NOUN PROPN CCONJ INTJ ADP DET NOUN _ DET PROPN VERB _ DET PROPN INTJ NOUN CCONJ NOUN NOUN NOUN
nchallah b gloub les joueurs w d3awi cha3b ljazairi l jazairi fi dakhel w l kharej lyoum l youm luna erbha b 2 - 0	INTJ ADP NOUN DET NOUN CCONJ NOUN NOUN _ DET ADJ ADP NOUN CCONJ DET NOUN _ DET NOUN PROPN VERB ADP NUM PUNCT NUM
jiboulna josé mourinio kayan l3attttttttttt l 3attttttttttt plz khalouna mel m el bricolage nhawso ndo la coupe world	VERB PROPN PROPN VERB _ DET NOUN INTJ VERB _ ADP DET NOUN VERB VERB DET NOUN NOUN
al hodod maghlo9a m3a le Maroc aghal9oha aussi m3a tunis wa rtaho bach tasbah aljazair al jazair ghay akhi a3la 3a9li yazza	DET NOUN ADJ ADP DET PROPN VERB ADV ADP PROPN CCONJ VERB ADP VERB _ DET PROPN ADJ NOUN ADJ NOUN ADJ
c'est c' est le vrai probleme qui se pose dans tout l'algerie l' algerie yen3al bouha hekouma	_ PRON VERB DET ADJ NOUN PRON PRON VERB ADP ADJ _ DET PROPN VERB NOUN NOUN
yawwwwwwwww rouhe tal3abe m3a rasek hta mine tafrat fina yaw bay bay licipe l icipe national	INTJ VERB VERB ADP NOUN ADP ADP VERB PRON INTJ INTJ INTJ _ DET NOUN ADJ
rabi m3ak ya okhti hadha ibtilaa mina allah fa isbiri wa sawfa tanalina bi idhni allah	PROPN PRON INTJ NOUN PRON NOUN ADP PROPN ADP VERB CCONJ PART VERB ADP NOUN PROPN
mazelt dima wagaf makra contre la kamora	VERB ADV ADJ ADP ADP DET PROPN
lotfi howa alrap al rap alhakiki al hakiki w 3ajbatni ta3 koulach machi donc chra	PROPN PRON _ DET NOUN _ DET ADJ CCONJ VERB ADP PRON PART CCONJ VERB
je pense ke hana les algerienes jamais nt3almo mel m el lghaltat ta3 el madi la meme erreur ta3 la guénnié normelment nala3bo m3a equipe mel m el afrique wach jab leurgway l eurgway lla zombié ???????? kima wach jab l argentin lal l al guénnié	PRON VERB SCONJ PRON DET NOUN ADV VERB _ ADP DET NOUN ADP DET NOUN DET ADV NOUN ADP DET PROPN ADV VERB ADP NOUN _ ADP DET PROPN PRON VERB _ DET PROPN PART PROPN PUNCT ADP PRON VERB DET PROPN _ ADP DET PROPN
stylo tgoul 3lih teroriste m3amar bel b el mesk	NOUN VERB PRON ADJ ADJ _ ADP DET NOUN
tefal waldih weklo lo rahej ta3 al firan	NOUN NOUN VERB PRON NOUN ADP DET NOUN
da 3aiza kalem l algerie est qualifiee	PRON ADJ NOUN DET PROPN VERB ADJ
ma 3andou la rahma la chafaka	PART PRON PART NOUN PART NOUN
a3toni klache wainkem ya hokam le3rab le 3rab sur ragdine m3a nsakem fe dar wo khawtkem ymoto ( ALAH AKBER	VERB NOUN ADV INTJ NOUN _ DET ADJ ADV ADJ ADP NOUN ADP NOUN CCONJ NOUN VERB PUNCT PROPN ADJ
inchallah en beynulhum beli keyen el balo 3adna 1 2 3 viva algerien	INTJ PRON VERB SCONJ VERB DET NOUN PRON INTJ INTJ INTJ VERB NOUN
allah el mousta3ane wa hasbouna allah wa ni3ma el wakil mina el mafroude yatoube ila allah mine zina wa el ghuinaa wa lakne yatamada fi ma3ssia nassihati lahou bi eltawba el tawba wa istighfar	PROPN DET ADJ CCONJ VERB PROPN CCONJ ADJ DET ADJ PRON DET ADJ VERB ADP PROPN ADP NOUN CCONJ DET NOUN CCONJ CCONJ VERB ADP NOUN NOUN PRON ADP _ DET NOUN CCONJ NOUN
je t'aime t' aime boughera et vive l'algerie l' algerie rana ga3 avec l'khadra l' khadra contra 3la mssawra 123 viva l'algerie l' algerie jusqu'a jusqu' a la fin	PRON _ PRON VERB PROPN CCONJ VERB _ DET PROPN VERB ADV ADP _ DET PROPN ADP ADP NOUN INTJ VERB _ DET PROPN _ ADP ADP DET NOUN
rck t3ayi ki hya ki les supporteurs dyawelhaou nchalah tela3bo m3a kli3a el3am el 3am eldjay el djay	PROPN VERB ADP PRON ADP DET NOUN NOUN INTJ VERB ADP PROPN _ DET NOUN _ DET ADJ
ana ngoul li yaklou al klabe w gatouta hachakom mabkat ma3icha m3ahoum rahom tawlo bezaf; viva l'algerie l' algerie	PRON VERB PRON VERB DET NOUN CCONJ NOUN PRON VERB NOUN PRON VERB VERB ADV VERB _ DET PROPN
inchaalah le mois de ramadhan el mobarak yadkhol 3ala el moslimouns bi el khir w al ajr ya rabe	INTJ DET NOUN ADP NOUN DET ADJ VERB ADP DET NOUN ADP DET NOUN CCONJ DET NOUN INTJ PROPN
brabi b rabi nchalah hna la ntkalifaw ya rabi kon m3ana aaaaaaaaaaaaaaaaaaaaaaaaaaaaaaamiiiiiiiiiiiiiiiiiiiiiiiiiiiiiiiiiiiiiiiiiiin	_ ADP PROPN INTJ PRON PART VERB INTJ PROPN VERB PRON INTJ
W nefkér khrouf meskine kil ki l marionette	CCONJ VERB NOUN ADJ _ ADP DET NOUN
Tahia ghadafi ou rabi m3ak nchallah la jordan wala nato rayhin y'kono khir men ghadafi ila alamam al amam	VERB PROPN CCONJ PROPN PRON INTJ PART PROPN CCONJ PROPN ADJ VERB ADJ ADP PROPN ADP _ DET NOUN
Le probleme c’est c’ est que had l’affaire l’ affaire feha relation	DET NOUN _ PRON VERB PRON PRON _ DET NOUN PRON NOUN
âlgerie fi dmna nchallah yafar7ouna maroc khoutna we ana natmna ta3adoul bayne farikayne	PROPN ADP NOUN INTJ VERB PROPN NOUN CCONJ PRON VERB NOUN ADP NOUN
pour battre la JSK ? Et cette saison wache dertou m3a l'OMR l' OMR ki chritou ga3 les joueurs de l'OMR l' OMR pauvre sport Algérien	ADP VERB DET PROPN PUNCT CCONJ DET NOUN PRON VERB ADP _ DET PROPN ADV VERB ADJ DET NOUN ADP _ DET PROPN ADJ NOUN ADJ
Des années wra des années barkanani ani 3ayane	DET NOUN ADP DET NOUN VERB PRON ADJ
allez les verts charfouna kima el3ada el 3ada w khaliw elfer3awn el fer3awn yahbal lah ibarek et allah ay3awankoum lah ibarek et allah ay3awankoum hamdoulllah moi je sui harrag a barsa vive el harga et vive l 'orope) win t3alamte takra	VERB DET PROPN VERB ADP _ DET NOUN CCONJ VERB _ DET NOUN VERB PROPN VERB CCONJ PROPN VERB PROPN VERB CCONJ PROPN VERB INTJ PRON PRON VERB ADJ ADP PROPN VERB DET NOUN CCONJ VERB DET PROPN ADV VERB VERB
allez les verts un grand mot pour une grande nation avec un seul coeur ya rabi la victoire fe le 15 jour ta3 ramdhan m3ak ya lekhadhra le khadhra m3ak ya dziare ou rabi m3akoum ya les verts et echiekh e chiekh saadan bon courage	VERB DET PROPN DET ADJ NOUN ADP DET ADJ NOUN ADP DET ADJ NOUN INTJ PROPN DET NOUN ADP DET NUM NOUN ADP PROPN PRON INTJ _ DET PROPN PRON INTJ PROPN CCONJ PROPN PRON INTJ DET PROPN CCONJ _ DET NOUN PROPN ADJ NOUN
kite koune anta hdar asahra se3iba w maranache nakhalso bien w ki nmouto yakatero 3azaya w tanesake d la ilah illa allah assalamou as salamou alikoum allahouma a3inna 3ala thikrika oua 3ala choukrika oua 3ala housni 3ibadatika	ADV VERB PRON VERB NOUN ADJ CCONJ VERB VERB ADV CCONJ ADV VERB VERB NOUN CCONJ VERB X PART PROPN PART PROPN _ DET INTJ PRON PROPN VERB ADP NOUN CCONJ ADP NOUN CCONJ ADP ADJ NOUN
ya rabi ostar rabi yjib el khir hadi 3alama min 3alamat esa3a e sa3a	INTJ PROPN VERB PROPN VERB DET NOUN PRON NOUN ADP NOUN _ DET NOUN
Kayen ghâchi fel f el jame3 , ness raqed w ness yesma3 , jm'en j m' en fou ana dis feddar fe ddar	VERB NOUN _ ADP DET NOUN PUNCT NOUN ADJ CCONJ NOUN VERB PUNCT _ PRON PRON PRON VERB PRON VERB _ ADP NOUN
la vectoir pas pour boutef c pour le cul de boutef ya 3atayinnnnnnnnnnnnnnnnnnnn	DET NOUN ADV ADP PROPN VERB ADP DET NOUN ADP PROPN INTJ ADJ
en dit en arabe ma 3ade khouh c paraille pour sarko et les juif	PRON VERB ADP NOUN PART ADV NOUN VERB ADJ ADP PROPN CCONJ DET NOUN
alllah yasatar had ala3am ala 3am nachallah bac 2011 pour tout	PROPN VERB PRON _ DET NOUN INTJ NOUN NUM ADP PRON
hadou khaddamin kima la police o elmo3alimin el mo3alimin	PRON NOUN ADP DET NOUN CCONJ _ DET NOUN
JSS toujours l3am l 3am jay nkahrou JSK w USMA	PROPN ADV _ DET NOUN ADJ VERB PROPN CCONJ PROPN
pfffffffffffffffffffffffffffffffff ci pas vrais hadi 3ataba doross makanach tollll !!	INTJ VERB ADV ADJ PRON NOUN NOUN VERB NOUN PUNCT
Kanet fond monumental , darou sah fawda mentale	VERB NOUN ADJ PUNCT VERB ADJ NOUN ADJ
hadoo talaba hayawanett o wled chare3 ma3andhoomch assl ghayr char3iyine mayehchmooch kima rahom yhawssoo fi dyerhoom thani la hechma la waloo dayou thine	PRON NOUN NOUN CCONJ NOUN NOUN ADP NOUN PART ADJ VERB ADV VERB VERB ADP NOUN ADV PART NOUN PART PRON VERB NOUN
ya khoya kimha wéla batél ntta inssan fachél ya sa3dan madabik téstakil baki ghi ntta li mahali yék koulna nkamlou m3a el mahaliyine ntta 3lah bkit	INTJ NOUN SCONJ VERB NOUN PRON NOUN ADJ INTJ PROPN VERB VERB ADJ PART PRON PRON ADJ INTJ PRON VERB ADP DET ADJ PRON ADV VERB
tahiati ben messaoudi benaissa je souhaite une bonne continuation pour notre equipe national chfaya f l'3adyane l' 3adyane	VERB PROPN PROPN PROPN PRON VERB DET ADJ NOUN ADP DET NOUN ADJ ADV ADP _ DET ADJ
wach ygoul l3abd l 3abd rhir la hawla wa kowata ila billah bi llah	ADV VERB _ DET NOUN PART PART NOUN CCONJ NOUN PART _ ADP PROPN
normal hada chie rahou maoujoud min bekri ou zid bziada b ziada ediouana e diouana 3ati lhoum drahem bark ou dakhel ouech habit	ADJ PRON NOUN VERB ADJ ADP ADV CCONJ VERB _ ADP ADV _ DET NOUN VERB PRON NOUN ADV CCONJ VERB PRON VERB
hhhhhhhhhhhhhh messi yal3ablkou f 5 juillet ntouma mrad wakil yewwwwwwwwwwwwwww makash manha argentinew argentine w la france yal3abou f dzair hhhhhhhhhhhhhhh ahalmou ahalmouu	INTJ PROPN VERB ADP NUM PROPN PRON ADJ NOUN INTJ VERB PRON _ NOUN CCONJ DET PROPN VERB ADP PROPN INTJ VERB VERB
la hawla wa la kowata ila bilah bi lah	PART NOUN CCONJ PART NOUN PART _ ADP PROPN
one two three viva lalgerie l algerie dima m3ak ya dzair w vive lequipe l equipe nationale lyoum l youm w ghodwa w rabi ykhalilna papa sa3dan je t'aime t' aime ya dzair i love you bchawiya b chawiya tachalghicham	INTJ INTJ INTJ VERB _ DET PROPN ADV PRON INTJ PROPN CCONJ VERB _ DET NOUN ADJ _ DET NOUN CCONJ NOUN CCONJ PROPN VERB NOUN PROPN PRON _ PRON VERB INTJ PROPN PRON VERB PRON _ ADP NOUN VERB
mala ne7bas hena c non tegoul hadaya faux	ADV VERB ADV ADV X VERB PRON ADJ
pour 66 67 Vous nous comparé aVec les européens c'est c' est Vraiment graVe Vous allez Voir 9a tres prochainments Lorsque Vous Voyez Vos argent chez eux Lan yardha 3anka elyahouda el yahouda wa nassara hata tatabi3a milatahoum	ADP PRON PRON PRON PRON VERB ADP DET NOUN _ PRON VERB ADV ADJ PRON VERB VERB ADV ADV ADV SCONJ PRON VERB DET NOUN ADP PRON PART VERB PRON _ DET NOUN CCONJ NOUN ADP VERB NOUN
vive boutaflika lokane jawe wakefine el rejale m3ahe lokane dezayere rahi 3endeha cheda fi el 3alame	VERB PROPN SCONJ VERB ADJ DET NOUN PRON SCONJ ADJ VERB PRON NOUN ADP DET NOUN
ma3adnach les stade	ADP DET NOUN
prkoi cette guere ya les frere du caire ya3ni hna rabhinkoum w rabi kbir rbahtou ghir el 3ayb hahaha	ADV DET NOUN INTJ DET NOUN ADP PROPN INTJ PRON VERB CCONJ PROPN ADJ VERB PART DET NOUN INTJ
hadehe tiflla mallamih 3arbiya 100 pour 100	PRON NOUN NOUN ADJ NUM ADP NUM
nchalah berbeh 3alik khouya chaouchi et vive mouloudia	INTJ VERB PRON NOUN PROPN CCONJ VERB PROPN
J m'en m' en fou belfawdha b el fawdha mental , 3andi gosto felfootball f el football ga3 la jeunesse malade mentale	PRON _ PRON PRON VERB _ ADP DET NOUN ADJ PUNCT PRON NOUN _ ADP DET NOUN ADJ DET NOUN ADJ ADJ
rabi m3akom	PROPN PRON
qui savent bien que el3amal el 3amal el 3amal 3ibada	PRON VERB ADV SCONJ _ DET NOUN DET NOUN NOUN
vive el 3ouhda errabi3a e rrabi3a	VERB DET NOUN _ DET ADJ
ila nimro 7 non ahana al jazyriyn ma3a al kadafiy anta tratr vive al kadafiy oki	ADP NOUN NUM INTJ PRON DET NOUN ADP DET PROPN PRON ADJ VERB DET PROPN INTJ
wi w i goul w igoul l babaha khelina m3aha hena f al bit khatak al 3efrite koun yakheraj o yasken fik	_ CCONJ PRON VERB CCONJ VERB ADP NOUN VERB PRON ADV ADP DET NOUN VERB DET NOUN VERB VERB CCONJ VERB PRON
matdirou walou antouma tdjibouha et fé la fin t3aourouha	VERB PRON PRON VERB CCONJ ADP DET NOUN VERB
yak dinya klk jours 3lash rakoum tkalkou fi rwahkoum pour rien yji nhar li ykoun ma3andoush ywali 3andou deniya douwara li 3talou rabi w mayestahelsh w ma diresh niya hada rabi youmhil w la youhmil imala koul wahad yahmed ni3ma w yesbar	INTJ NOUN ADV NOUN ADV VERB VERB ADP NOUN ADP PRON VERB NOUN PRON VERB VERB VERB PRON NOUN ADJ PRON VERB PROPN CCONJ VERB CCONJ PART VERB NOUN PRON PROPN VERB CCONJ PART VERB ADV DET NOUN VERB NOUN CCONJ VERB
galouli galou li wach dak , sure rak meskine	_ VERB PRON PRON VERB PUNCT ADJ VERB ADJ
bon chance l'entente l' entente zekara fl3adiane f l 3adiane sur tout cabba les champion de monde ou mebrouk la cup de monde	ADJ NOUN _ DET NOUN ADV _ ADP DET NOUN ADV X PROPN DET NOUN ADP NOUN CCONJ INTJ DET NOUN ADP NOUN
chaque faut pas m3aha braya maktouba fouguha	DET ADJ NOUN PRON NOUN ADJ PRON
nchallah hna lirouhou li rouhou soud afrique 2010 w ndirou hala w massar maradi ydirou walou mahad 3adna sa3dan w ziani matmou gawawi ghazal et vive algerie wwwsouadalgerieskyblogcom	INTJ PRON _ PRON VERB PROPN PROPN NUM CCONJ VERB NOUN CCONJ PROPN ADJ VERB PRON ADV PRON PROPN CCONJ PROPN PROPN PROPN PROPN CCONJ VERB PROPN PROPN
les agents de securite li yakhadmou fi la fac yakhalsou 13000 win rahi al 3adala makhasnache ya li m3awnin al yahod 3ayartona et darwak t chaj3ona rir 3la gazze mkhassnache	DET NOUN ADP NOUN PRON VERB ADP DET NOUN VERB NUM ADV VERB DET NOUN VERB INTJ PRON VERB DET NOUN VERB CCONJ ADV PRON VERB PART PART PROPN VERB
ki kamlou machrou3 chkoun 3andou lhak l hak bach yadkhoulhoum ghir familiya ta3 flan wa flan kima club de pin dawha ga3 mayadkhoulhach mouwatin 3adi	ADV VERB NOUN PRON PRON _ DET NOUN ADP VERB PART NOUN ADP NOUN CCONJ NOUN SCONJ NOUN ADP NOUN VERB ADV VERB NOUN ADJ
allah ybarek fi 3ilmih wa nafa3a bihi al omma wa al 3ibad mrahba bih f 3annaba w fel f el jazair	PROPN VERB ADP NOUN CCONJ VERB PRON DET NOUN CCONJ DET NOUN INTJ PRON ADP PROPN CCONJ _ ADP DET PROPN
ana ma3a ta3lik 1 vive mouloudiaaaa	PRON ADP NOUN NUM VERB PROPN
rabi ychfihom inchallah wykoun w ykoun m3a waldihom	PROPN VERB INTJ _ CCONJ VERB ADP NOUN
hassbouh houwa weli m3ah sur mazalou shabah fel f el houkouma	NOUN PRON VERB PRON ADJ ADV NOUN _ ADP DET NOUN
mazel 3ndna la chance lazem nkouno m3ahom	ADV PRON DET NOUN VERB VERB PRON
matfakarnich bel b el passé , 10 snine f domaine	VERB _ ADP DET NOUN PUNCT NUM NOUN ADP NOUN
ben chikha rabi m3aque je si quille goura jamais des c lents	PROPN PROPN PROPN PRON PRON VERB SCONJ VERB ADV DET PRON ADJ
rana b3ad 3la niveau ta3 afrique on a pas de niveau du tout	VERB ADJ ADP NOUN ADP PROPN PRON VERB ADV ADP NOUN ADP ADV
wa hal ma fa3ala3o al 3askare ma3ana fi asanawate a sanawate al akhira kana sagira lida yajibe an nofakira fi machakilina wa malana wa machakil al magreb	CCONJ ADV PRON VERB DET NOUN PRON ADP _ DET NOUN DET ADJ VERB ADJ ADV VERB ADV VERB ADP NOUN CCONJ NOUN CCONJ NOUN DET PROPN
salem 3alykoum ou rahmate elle ahe wa baraktouh	INTJ PRON CCONJ NOUN PROPN X CCONJ NOUN
besah b e sah ya jam3a hadou li fi libya wellah ma thouar hadou	_ ADP DET NOUN INTJ NOUN PRON PRON ADP PROPN INTJ PART ADJ PRON
bien sur nerbah sur tous me3a maser	ADV ADV VERB ADV X ADP PROPN
had al khabith lazem ytairoulou rassou inchallah ya rabbi win rah al hokm al 3adil ??????	PRON DET ADJ VERB VERB NOUN INTJ INTJ PROPN ADV VERB DET NOUN DET ADJ PUNCT
ana dhad roj3 lamouchaia y3atik saha y a kader 02	PRON VERB NOUN PROPN VERB NOUN INTJ X PROPN NUM
rabi y3awnek ida konti sedka	PROPN VERB SCONJ VERB ADJ
rck makan walo 3ir maytal3och khir 3am ljai l jai ya habto nchalah vive milaha et usmh	PROPN VERB PRON ADP VERB ADJ NOUN _ DET ADJ INTJ VERB INTJ VERB NOUN CCONJ PROPN
merci les verts wa nchalah ya rabi lmondial l mondial 2010 rayhin w jaych cha3b m3ak ya saadan	INTJ DET PROPN CCONJ INTJ INTJ PROPN _ DET NOUN NUM ADJ CCONJ NOUN NOUN PRON INTJ PROPN
salam 3alikom fi bladna el hamdoulilah makanech anfelouanza el khanazir mais kayan anfelouanza el 3ibad hahahahahahaha	INTJ PRON ADP NOUN DET INTJ VERB NOUN DET NOUN CCONJ VERB NOUN DET NOUN INTJ
khass el 3amya ri el kholle	VERB DET NOUN ADP DET NOUN
l3ab m3a chorouk /puisque chourouk contre saadane a 100 %	NOUN ADP PROPN SCONJ PROPN ADP PROPN ADP NUM NOUN
vive USMAnnaba pour tjr;;;;;;;; had l 3am ndirou hala nchallah ya rabbi SAHA 3IDKOM	VERB PROPN ADP ADV PRON DET NOUN VERB NOUN INTJ INTJ PROPN NOUN NOUN
belhem b el hem feregna w belfa9r b el fa9r w elhem el hem felegna	_ ADP DET NOUN VERB CCONJ _ ADP DET NOUN CCONJ _ DET NOUN VERB
3la dika nahder bah nfeya9 had al beghal	ADP PRON VERB ADP VERB PRON DET NOUN
le n 25 v etes un algerien we rak tal3ab fiha masri	DET NOUN NUM PRON VERB DET NOUN CCONJ VERB VERB PRON NOUN
C’est C’ est bien ana kane qader yasrali haka	_ PRON VERB ADV PRON VERB ADJ VERB PRON
3amro khaled n'est n' est pas un 3alem c juste un Da3iya il se goure mais pour connaitre l'histoire l' histoire de l'islam l' islam c'est c' est pas un mofti est il est excellent dans son domaine allah yahdikom wala yadikom ya les adorateurs de belhaj	PROPN PROPN _ ADV VERB ADV DET NOUN VERB ADV DET NOUN PRON PRON VERB CCONJ ADP VERB _ DET NOUN ADP _ DET NOUN _ PRON VERB ADV DET NOUN CCONJ PRON VERB ADJ ADP DET NOUN PROPN VERB CCONJ VERB INTJ DET NOUN ADP PROPN
Bessah Be ssah mechni kelb , mechni sauvage	_ ADP NOUN PRON NOUN PUNCT PRON ADJ
salam 3alaikoum wa rahmatoulah rahmatou lah	INTJ PRON CCONJ _ NOUN PROPN
bravooooo les vert rana m3akom jusqu a la mort	INTJ DET PROPN VERB PRON ADP ADP DET NOUN
besahate be sahate likipe l ikipe nasyunal rabi yahefadeheme me 3ayene	_ ADP NOUN _ DET NOUN ADJ PROPN VERB ADP NOUN
tbahdila ya wlid ami draham wache ediro mais 3andek el hak drahem !!!!	NOUN INTJ NOUN NOUN NOUN ADV VERB CCONJ PRON DET NOUN NOUN PUNCT
enfin hadi haya alhadra al hadra ta3 rajala ta7ya alkhadra al khadra w dima m3ak ya sa3dan vive l'algerie l' algerie	ADV PRON PRON _ DET NOUN ADP NOUN VERB _ DET PROPN CCONJ ADV PRON INTJ PROPN VERB _ DET PROPN
et ceux qui ont profité de l'argent l' argent d'El d' El khalifa parmi les gens du pouvoir wach hekmet 3alihoum el Mahkama ???	CCONJ PRON PRON VERB VERB ADP _ DET NOUN _ ADP DET PROPN ADP DET NOUN ADP NOUN PRON VERB PRON DET NOUN PUNCT
en demande chadli l3amri	PRON VERB PROPN PROPN
El corps yetpoura w enta mazalek 3aych fih	DET NOUN VERB CCONJ PRON PRON ADJ PRON
El hamdoulilah min 3andna entraineur kima sa3dan ou lazem nkounou m3ah rabhin ou la khasrin	DET INTJ ADP PRON NOUN ADP PROPN CCONJ VERB VERB PRON ADJ CCONJ CCONJ ADJ
nchallah califier lmondail l mondail ya rabi rana m3ak ya chikh saadan	INTJ VERB _ ADP NOUN INTJ PROPN VERB PRON INTJ PROPN PROPN
slt tous le monde vive crb ou nchalah championnait 2009 _ 2010 ou rana ga3 m3a the big kerbedj	INTJ ADJ DET NOUN VERB PROPN CCONJ INTJ NOUN NUM PUNCT NUM CCONJ VERB ADV ADP DET ADJ NOUN
alli yji la bladna yal3ab 3lina wa yrouh	PRON VERB ADP NOUN VERB PRON CCONJ VERB
allah yrhamhom wyj3alhom w wyj3alhom fi jennatihi aamin ya rabi	PROPN VERB _ CCONJ VERB ADP NOUN INTJ INTJ PROPN
inchallah ndirou nulle m3a la slovénie	INTJ VERB NOUN ADP DET PROPN
te9ra f journal 7ewayej ta3 aflam	VERB ADP NOUN NOUN ADP NOUN
mustapha paris ya sans jose lje pence que tu connais plus echahada e chahada rabi inchallah yahchrak m3a el kofar	PROPN PROPN INTJ PROPN PROPN PRON VERB SCONJ PRON VERB ADV _ DET NOUN PROPN INTJ VERB ADP DET NOUN
hchouma 3likoum t3awdoulna les articles d'hier d' hier à alarabiya al arabiya ya jma3a win rahoum syndicat algerien des paramedicaux win rah hakna krahna min al wo3oud	NOUN PRON VERB DET NOUN _ ADP NOUN ADP _ DET PROPN INTJ NOUN ADV VERB NOUN ADJ DET NOUN ADV VERB NOUN VERB ADP DET NOUN
vous aimez pas les homme comme m3amar	PRON VERB ADV DET NOUN ADP PROPN
Kount qader sinon , nfeleg les poumons	VERB ADJ SCONJ PUNCT VERB DET NOUN
ya jma3a galek kayen match le dimache a 22	INTJ NOUN VERB VERB NOUN DET NOUN ADP NUM
je vex dire a monsieur saadane roh bezaf 3lik 3rafna niveau ta3ak bas et tres bas 3adna equipe mais ma3adnache entraineur bazaf tpahdayel ya sa3dane allah yastar fe lmondial l mondial	PRON VERB VERB ADP NOUN PROPN VERB ADV PRON VERB NOUN PRON ADJ CCONJ ADV ADJ PRON NOUN CCONJ VERB NOUN ADV NOUN INTJ PROPN PROPN VERB ADP _ DET NOUN
allah y3awnkom nchalah tous en somble contre cette pourriture	PROPN VERB INTJ ADJ ADV X ADP DET NOUN
sa fi plaissre 3andha des jouers lah ybarek alor bon continuation a tout les jouers	PRON VERB NOUN PRON DET NOUN PROPN VERB ADV ADJ NOUN ADP ADJ DET NOUN
khaliwna n3aichou ki-nasse ki- nasse	VERB VERB _ ADP NOUN
Ma3andekch adem a dem demkoum rachoua les ss temoignent	VERB _ DET NOUN NOUN NOUN DET PROPN VERB
on ne sait plus koi penser nous les Algeriens qui soutenir un dictateur qui tue sont peuple sans scupule ou bien des revolutionnaires qui travaillent pr les europeens et les americains ?? allah ansor al hak atna al kadir 3ala koul chay	PRON ADV VERB ADV PRON VERB PRON DET NOUN PRON VERB DET NOUN PRON VERB DET NOUN ADP NOUN CCONJ ADV DET ADJ PRON VERB ADP DET NOUN CCONJ DET NOUN PUNCT PROPN VERB DET NOUN PRON DET ADJ ADP DET NOUN
si koi wache rakom tahkiw andha 3ans 3 ans meli walat 1milyar 1 milyar machi 400 mil rabi yahdik ya journaliste	VERB PRON ADV VERB VERB PRON _ DET NOUN ADV VERB _ DET NOUN PART DET NOUN PROPN VERB INTJ NOUN
one two three viva l'algerie l' algerie et viva saadane et m3ake el koudame	INTJ INTJ INTJ VERB _ DET PROPN CCONJ VERB PROPN CCONJ PRON ADP NOUN
allahoma onsor gaza 3ala a3da2 din	PROPN VERB PROPN ADP NOUN NOUN
ha ha ha BAC 2008 BYE n'wakal 3alik rabi ya ben bouzid mais toujours KAYEN RABI	INTJ INTJ INTJ PROPN NUM INTJ VERB PRON PROPN INTJ PROPN PROPN CCONJ ADV VERB PROPN
yekhi hleft 3ala 3000000 da lah mameditech azayed w medit moins khatrakech mechhah ya serrar	INTJ VERB ADP NUM NOUN PART VERB ADJ CCONJ VERB ADJ ADP ADJ INTJ PROPN
lessentiel l essentiel on esper qu'il qu' il va apporter qq et laisser ziani howa li ye3alam meghni c quoi l'islame l' islame	_ DET ADJ PRON VERB _ PRON PRON VERB VERB PRON CCONJ VERB PROPN PRON PRON VERB PROPN AUX PRON _ DET NOUN
wech hamiz habat twali lingliz l ingliz hhhhhhhhhhhhh 3aychine fiha ghir les miliardaire mai ga3 ji3anine	INTJ PROPN VERB VERB _ DET ADJ INTJ ADJ PRON PART DET NOUN CCONJ ADV ADJ
Allah ma3akoum mes feres algeriens demain inchallah tout changera l'espoir l' espoir reviendra et la prosperite' reignera	PROPN PRON DET NOUN NOUN ADV INTJ PRON VERB _ DET NOUN VERB CCONJ DET NOUN VERB
inchalah m3a m3aiza tazha annaba nchalah la coupe brabi b rabi had l3am l 3am dima nas besbes	INTJ ADP PROPN VERB PROPN INTJ DET NOUN _ ADP PROPN PRON _ DET NOUN ADV NOUN PROPN
Waach nkheyyer qalbi taab , waach nchouf nqoul chbab , jm'en j m' en fou anaya ghleqt l baab	PRON VERB NOUN VERB PUNCT PRON VERB VERB NOUN PUNCT _ PRON PRON PRON VERB PRON VERB DET NOUN
je oulé juste ous dire que c'est c' est du bla bla moi j'ai j' ai le Bem cette annee chuii néé en 1997 depuii que j'aité j' aité au 1er annéé primaire j'ai j' ai jamais dis tata w 3amou Rakouum tzidou fiha bzzf	PRON VERB ADV PRON VERB SCONJ _ PRON VERB DET NOUN X PRON _ PRON VERB DET PROPN DET NOUN VERB ADJ ADP NUM ADV SCONJ _ PRON VERB ADP ADJ NOUN ADJ _ PRON AUX ADV VERB NOUN CCONJ NOUN VERB VERB PRON ADV
dorka m3a lem3icha le m3icha lghalya l ghalya hadi 2 et 3 millions ya rabi techri bihem always lel l el madame !	ADV ADP _ DET NOUN _ DET ADJ PRON NUM CCONJ NUM NOUN INTJ PROPN VERB PRON NOUN _ ADP DET NOUN PUNCT
vive elkhala el khala w rabi m3akom w yfarahkom kima farahto ga3 eldjazayer el djazayer	VERB _ DET NOUN CCONJ PROPN PRON CCONJ VERB ADP VERB ADJ _ DET PROPN
ya hlil ne khadma ne cituation rabi m3ahem o nchlh tatsagam leyam l eyam	INTJ INTJ ADV NOUN ADV NOUN PROPN PRON CCONJ INTJ VERB _ DET NOUN
1erement kifach had etafla e tafla terkeb m3a nesse mate3rafhemh !!!!????? w kifahe gadra t affiche les fotos taw3ha f les journeaux !!!!!	ADV ADV PRON _ DET NOUN VERB ADP NOUN VERB PUNCT CCONJ ADV ADJ PRON VERB DET NOUN PRON ADP DET NOUN PUNCT
allah y3aouankom la police alg	PROPN VERB DET NOUN ADJ
allah m3akom ya les ver inchallah en va gagné le match et bonne chanse a ce team wallah fort	PROPN PRON INTJ DET PROPN INTJ PRON VERB VERB DET NOUN CCONJ ADJ NOUN ADP DET NOUN INTJ ADJ
mob en regional !!!!! c'est c' est pas grave tal3a la3m l a3m ljay l jay nchalah	PROPN ADP ADJ PUNCT _ PRON VERB ADV ADJ NOUN _ DET NOUN _ DET ADJ INTJ
Kima fel f el la Colombie , n3oud nbi3 bel b el kbir	SCONJ _ ADP DET DET PROPN PUNCT VERB VERB _ ADP DET ADJ
el tal3a djifa wala nsit	DET NOUN NOUN CCONJ VERB
tabi ikon am3ahom nchallah kollona nataalamo min adjlihim	ADJ VERB PRON INTJ PRON VERB ADP NOUN
ki l'3ad l' 3ad on est toujours les derniers pffff	ADP _ DET NOUN PRON VERB ADV DET ADJ INTJ
vive cabba anchallah trbah elborj el borj babia + bba = contra 3al stayfya wa nfarho fi eleulma	VERB PROPN INTJ VERB _ DET PROPN PROPN PUNCT PROPN PUNCT NOUN ADP NOUN CCONJ VERB ADP PROPN
soyez fréres dans la vie commune mais étrangers dans les affaires al3ab la3bak mr solo16d	VERB NOUN ADP DET NOUN ADJ CCONJ ADJ ADP DET NOUN VERB NOUN NOUN PROPN
mrahba bikom 3andna w natmana natal3o bjouj	INTJ PRON PRON CCONJ VERB VERB NOUN
waman wa man katala mouminan mota3amidan hadiba ellaho 3alayhi wa la3anaho wa a3ada laho 3adaban 3adima ** mziya kayane rabi ihassabe les térroriste	_ CCONJ PRON VERB NOUN ADV VERB PROPN PRON CCONJ VERB CCONJ VERB PRON NOUN ADJ PUNCT ADV VERB PROPN VERB DET NOUN
daradji tout les algerien m3ak nta rajal wa fhal ok w madirch 3la lhadra l hadra lfargha l fargha	PROPN ADJ DET NOUN PRON PRON NOUN CCONJ ADJ INTJ CCONJ VERB ADP _ DET NOUN _ DET NOUN
3awadha ya ziani awadha saha ftorkom	VERB INTJ PROPN VERB NOUN NOUN
al3alem al 3alem al 3alem lina au 123 viva L'algerie L' algerie	_ DET NOUN DET NOUN PRON CCONJ INTJ VERB _ DET PROPN
goutelkom mazel lespoire l espoire w nchalah contre engola farhona ya djma3a	VERB VERB _ DET NOUN CCONJ INTJ ADP PROPN VERB INTJ NOUN
3djebni wahed le comment	VERB NOUN DET NOUN
salame a tous le mondes inchalah tanzel a3lina lilat el kadre ou nartal3ou skara fel f el 3adyane	INTJ ADP ADJ DET NOUN INTJ VERB PRON NOUN DET NOUN CCONJ VERB NOUN _ ADP DET NOUN
la narbit ma hadata lelmountakhab l el mountakhab elwatani el watani bi jsk endana 3alaqat jidou matina ma3a les club egypsien surtous elahly el ahly and alisma3ili al isma3ili bienvenue a tizi ouzouet la nous joue pas au stade de 5 juil vive jsk	PART VERB PRON VERB _ ADP DET NOUN _ DET ADJ ADP PROPN PRON NOUN ADJ ADJ ADP DET NOUN ADJ ADV _ DET PROPN CCONJ _ DET PROPN INTJ ADP PROPN PROPN ADV PRON VERB ADV ADP NOUN ADP NUM PROPN VERB PROPN
ya cheikh ghleb zambia et rowanda c est la meilleur reponse por le ma3alem chahata	INTJ PROPN NOUN PROPN CCONJ PROPN PRON VERB DET ADJ NOUN ADP DET NOUN PROPN
vive fis la3natou allah 3alayka ya ouyahia publiez svp	VERB PROPN NOUN PROPN PRON INTJ PROPN VERB INTJ
3ladik 3la dik mechni wa7di meme d3if fi sa7ti	_ ADP PRON PART ADJ ADV ADJ ADP NOUN
siniour lahcen natmanna tal3ab fi bladk puisque l'algerie l' algerie tahtajk pas la france b chance chourouk	NOUN PROPN VERB VERB ADP NOUN SCONJ _ DET PROPN VERB ADV DET PROPN ADP NOUN PROPN
par ce que air algerie tkhadam m3arafha daz bark air rih	SCONJ X SCONJ NOUN PROPN VERB VERB VERB ADV NOUN NOUN
Habou ytelfouli el rai , yeguelbouni racaille	VERB VERB DET NOUN PUNCT VERB NOUN
crb tout jour fort 123 viva crb ou ssrir y3ayi	PROPN ADV X ADJ INTJ VERB PROPN CCONJ NOUN VERB
allahouma 3afina min ma ibtalayta el ba3dha min ibadek amine ya rab el 3alamine	PROPN VERB ADP PRON VERB DET NOUN ADP NOUN INTJ INTJ PROPN DET NOUN
hadh el jama3at kima el masounia kif kif zidolhoum el chi3a mel m el foug allah la t'rabah houm	PRON DET NOUN ADP DET NOUN ADV ADV VERB DET NOUN _ ADP DET NOUN PROPN PART VERB PRON
vive les algerien nchalah la cope des monde m3ake ya kadera diri hala	VERB DET NOUN INTJ DET NOUN ADP NOUN PRON INTJ PROPN VERB NOUN
we mell3be echahide e chahide hamlawi wellahi ardiyate elmeydane el meydane touhfa hegarine fe el3assima el 3assima meme fe setade te3e sabele jihhhhhhhhhhhhhhhhhhhhhawiya	CCONJ NOUN _ DET NOUN PROPN INTJ NOUN _ DET NOUN ADJ ADJ ADP _ DET NOUN ADV ADP NOUN ADP PROPN PROPN
bah les parant yfiko chwia alah ghalb 3lih raho ken y3ani houkmou 3end rabi	INTJ DET NOUN VERB ADV PROPN ADJ PRON VERB VERB VERB NOUN ADP PROPN
vive l'algerie l' algerie et nchalah narb7o angola wa ma yachafawach fina el 3adien	VERB _ DET PROPN CCONJ INTJ VERB PROPN CCONJ PART VERB PRON DET NOUN
mco walo vive nahd hada l3am l 3am la coup lina	PROPN PRON VERB PROPN PRON _ DET NOUN DET NOUN PRON
krahna ou rana m3awline on vous baisserai juskaus jusk au s ke vou nou aimé vive elheda el heda khir man nweliw des kamikaz	VERB CCONJ VERB ADJ PRON PRON VERB _ ADP ADP PRON SCONJ PRON PRON VERB VERB _ DET NOUN ADJ SCONJ VERB DET NOUN
adia 3ataba dorka mechou 7ram a chay lwa7ed l wa7ed chab w howa mazal fl bac c trop sa vraiment	PRON NOUN ADV PART ADJ DET NOUN _ ADP NOUN NOUN CCONJ PRON VERB ADP NOUN VERB ADV DET ADV
les yesma3komes tahedro tgole 3andkom tahbes rakom bokel kif kif rabiw w ladkom est surtot bnatkom mba3ed riklamio	PRON VERB VERB VERB PRON VERB VERB ADV ADV ADV VERB NOUN X CCONJ ADV NOUN ADV VERB
lé algériene rassssssa wa li 3adana bassa	DET NOUN NOUN CCONJ PRON VERB VERB
rabi m3a chorta mes hna rana habin nadokhlo madabikoum t3awnouna	PROPN ADP NOUN CCONJ PRON VERB ADJ VERB ADV VERB
ya madjer rouh el3ab m3a likedek raouraoua la mafiaaaaaaaaaa vive raouraoua	INTJ PROPN VERB VERB ADP PRON PROPN DET NOUN VERB PROPN
wa7ed may7et fi balo la misère l menha kharja	DET VERB ADP NOUN DET NOUN PRON PRON ADJ
ya el3agoune el 3agoune	INTJ _ DET ADJ
rabbi yachfiha inchallah goulou amine m3aya	PROPN VERB INTJ VERB INTJ PRON
al ghazw athakafifa a thakafifa hel lil l il jazayer mo3amela bil b il mithl mine addowal ad dowal el okhra	DET NOUN _ DET NOUN ADV _ ADP DET PROPN NOUN _ ADP DET NOUN ADP _ DET NOUN DET ADJ
yaw tehia madrid tellement ana 3aich ei katalonia el katalan akbar 3onsoria fi europa quero ganar el partido madrid seguro	INTJ VERB PROPN ADV PRON ADJ ADP PROPN DET NOUN ADJ NOUN ADP PROPN VERB VERB DET NOUN PROPN ADJ
tal3a nchalah moc koune tamchi reglou bye bye csc baia3ine dhouroume	NOUN INTJ PROPN SCONJ VERB ADJ INTJ INTJ PROPN NOUN NOUN
asalamo a salamo 3alaicom baraka allaho fika ya akhi wa zadaka allaho 3ilma li tanfa3a bihi al mouslimina asalamo a salamo natlobou mina al solotati ana toud3imouhou mitla ma tou da3imou al ghinaa wa arakssa a rakssa wa al 3afan no alfan al fan asalamo a salamo alaicom	_ DET INTJ PRON VERB PROPN PRON INTJ NOUN CCONJ VERB PROPN NOUN ADP VERB PRON DET NOUN _ DET NOUN VERB ADP DET NOUN SCONJ VERB ADP PRON VERB X DET NOUN CCONJ _ DET NOUN CCONJ DET NOUN ADV _ DET NOUN _ DET INTJ PRON
3ladik 3la dik ktebna w elklam el klam becherette be cherette	_ ADP PRON VERB CCONJ _ DET NOUN _ ADP NOUN
si si on le sais déja ella3ab el la3ab Sarko wa erracham e rracham Sarko	INTJ INTJ PRON PRON VERB ADV _ DET NOUN PROPN CCONJ _ DET NOUN PROPN
walah yasser mana3raf m3a da el ham kol waktah wahad yahakak les rêves ti3ooo	INTJ PROPN VERB ADP PRON DET NOUN DET NOUN NOUN VERB DET NOUN PRON
merci pour toi 3abd el 3AZIZE BOUTAFLIKA	INTJ ADP PRON PROPN DET PROPN PROPN
alors c simple ya shiekh saadan 3awed jibelna l'equipe l' equipe qu a jouer la qualification o khalina men yebdalacenshakouri	ADV VERB ADJ INTJ PROPN PROPN VERB VERB _ DET NOUN PRON AUX VERB DET NOUN CCONJ VERB ADP PROPN
voila lazem les algerien ya3arfou beli masrienne ta3 sah khawetena elfahem el fahem yefham	INTJ VERB DET NOUN VERB SCONJ NOUN ADP NOUN NOUN _ DET NOUN VERB
tela9 dar chera3 les proces ora les proces rolastion masali7 , o zid lha mariage forcé	NOUN NOUN NOUN DET NOUN ADJ DET NOUN NOUN NOUN PUNCT CCONJ VERB PRON NOUN ADJ
le logement en algerie c possible mais neta ou lem3aref le m3aref deyalek ou inchalah nedou kamel	DET NOUN PRON PROPN VERB ADJ CCONJ PRON CCONJ _ DET NOUN PRON CCONJ INTJ VERB ADJ
rabi m3ahem	PROPN PRON
domage tmanit yal3ab madabiya nla3bo la semain prochain bach il3ab bogara	INTJ VERB VERB NOUN VERB DET NOUN ADJ ADP VERB PROPN
la 3alayna	PART PRON
bhadha le niveau aso ma3endha ma teddi hadha l 3ame ya ssi medware	NOUN DET NOUN PROPN ADP PART VERB PRON DET NOUN INTJ NOUN PROPN
vive l'algerie l' algerie et rabi m3ak rafik	VERB _ DET PROPN CCONJ PROPN PRON PROPN
3aaaaaaaaaaaaaaaach le maroc	VERB DET PROPN
pour baba arrouj puisque tu es contre le NATO qui a sauVe des milliers de Libyiens dis moi pourquoi tu Vis dans un pays de NATO hlal 3alina Hram 3alihoum	ADP PROPN PROPN SCONJ PRON VERB ADP DET PROPN PRON AUX VERB DET DET ADP NOUN VERB PRON ADV PRON VERB ADP DET NOUN ADP PROPN ADJ PRON ADJ PRON
lazam ta3arfou ya ikhwani balli al insan lazam ydara3 3la charaf dyallou ou ki chffna na3ima tatnahgar mahmalnahach hadda ma kan	VERB VERB INTJ NOUN SCONJ DET NOUN VERB VERB ADP NOUN PRON CCONJ ADV VERB PROPN VERB VERB PRON PART VERB
pour moi duronie fi aray ; makanche kima assistam ta3 si el houari allah yarhmo el 3amel bark nfotiw 3la machrou3 hal el barlaman je suis sure que plus de 100 pour 100 yarf3o yadihoum	ADP PRON PROPN ADP NOUN PUNCT VERB ADP NOUN ADP NOUN DET PROPN PROPN VERB DET NOUN ADV VERB ADP NOUN NOUN DET NOUN PRON VERB ADJ SCONJ ADV ADP NUM ADP NUM VERB NOUN
m3ak ya sa3dan hat lw nakhasro vive lalgeire l algeire	PRON INTJ PROPN ADV SCONJ VERB VERB _ DET PROPN
bravooooo les jeunes rana m3akoum ga3	INTJ DET NOUN VERB PRON ADV
salem 3alikoum inchalah le pondium et les midailes d’or d’ or	NOUN PRON INTJ DET NOUN CCONJ DET NOUN _ ADP NOUN
tla3t f drouj w salt meme la zone rouge	VERB ADP NOUN CCONJ VERB ADV DET NOUN ADJ
awel mara dirou 7aja tasla7 fi 7yatkom mai ykater 5irkom 3ala koli 7al	ADJ NOUN VERB NOUN VERB ADP NOUN CCONJ VERB NOUN ADP DET NOUN
Israélienne sa fait rien puisque il y a beaucoup des joueurs palestinien l3bou f 3andhoum ya jma3a c'est c' est pas les prix qui sont cher walah yasser mana3raf m3a da el ham kol waktah wahad yahakak les rêves ti3ooo	NOUN PRON VERB PRON SCONJ PRON PRON VERB ADV DET NOUN NOUN VERB ADP PRON INTJ NOUN _ PRON VERB ADV DET NOUN PRON VERB ADJ INTJ PROPN VERB ADP PRON DET NOUN DET NOUN NOUN VERB DET NOUN PRON
Lebled Le bled ça y est ani dertelha braquage à l’italienne l’ italienne	_ DET NOUN PRON PRON VERB PRON VERB NOUN ADP _ DET NOUN
ah ya mourad derbouk b 3ainkon tarj3 liamat l iamat	INTJ INTJ PROPN VERB ADP NOUN VERB _ DET NOUN
al hadra le 7 ha khoya nechalkahe narabhoukome b 20 hena 3andna jamhoure ya narabhoukome ya temotou	DET NOUN DET PRON INTJ NOUN INTJ VERB ADP NUM ADV PRON NOUN CCONJ VERB CCONJ VERB
mourde megheni welah ysethle yl3be la coup du mondeya monde ya les algerienne d3iwe m3ana et golu ya rabi ychefih	PROPN PROPN INTJ VERB VERB DET NOUN ADP _ NOUN INTJ DET NOUN VERB PRON CCONJ VERB INTJ PROPN VERB
m3ak SOLO16DZRak fooort	PRON PROPN ADJ
tabkaw jordan et jarathim el3alam el 3alam ya jahala ya rab l'algerie l' algerie 130 3am o hiya tkharaj françe et jordan El-libiyin El- libiyin i3aytolhom tgol 3likom ga3 des imames w entouma haja ou machi 3arfinha	VERB PROPN CCONJ NOUN _ DET NOUN INTJ ADJ INTJ PROPN _ DET PROPN NUM NOUN CCONJ PRON VERB PROPN CCONJ PROPN _ DET NOUN VERB VERB PRON ADJ DET NOUN CCONJ PRON NOUN CCONJ PART VERB
ma3anda mankoloet au fond du nos ceoure on dit allah yadj3al elkehr el kehr psk vraimnt 3yna	ADP VERB ADP NOUN ADP DET NOUN PRON VERB PROPN VERB _ DET NOUN SCONJ ADV VERB
manassthakoukch pars que koun 3aytoulak léquipe l équipe national france matratich casse toi	VERB SCONJ SCONJ VERB VERB _ DET NOUN ADJ PROPN VERB VERB PRON
Chaque fin 6 mois zid 3awed had l’affaire l’ affaire	DET NOUN NUM NOUN VERB VERB PRON _ DET NOUN
hna jinhoume sahline directe 3a9bouna ou lamssarwa la mssarwa mezel pefffffff yakhi	PRON VERB ADJ ADJ VERB CCONJ _ DET NOUN VERB INTJ INTJ
chaba bazef hadi zizou 3andek lha9 l ha9 deja debhoh raho mkonjli kech nhar yadjebdoh ybi3oh	ADJ ADV PRON PROPN PRON _ DET NOUN ADV VERB VERB ADJ DET NOUN VERB VERB
usma lazem but hors jeux lokane mamarkache laifaoui lokane mazal le match yal3ab hata la prochaine journee	PROPN VERB NOUN ADP NOUN SCONJ VERB PROPN SCONJ VERB DET NOUN VERB ADP DET ADJ NOUN
ntmnalek el shifaa el 3ajel mn 3and allah khali imanek kawi matnsach le miracle de wassila f bahdja ina ma3A el 3osr yosra w l'algerie l' algerie et toute ma famille te soutien	VERB DET NOUN DET ADJ ADP ADP PROPN VERB NOUN ADJ VERB DET NOUN ADP NOUN ADP NOUN SCONJ ADP DET NOUN NOUN CCONJ _ DET PROPN CCONJ ADJ DET NOUN PRON VERB
lhaja l haja 1 rak bayen makch masri w llhaja ll haja 2 lbrizil l brizil w tlayen dartou m3ahoum score w lmarikan l marikan ?????????????????????	_ DET NOUN ADJ VERB ADJ VERB NOUN CCONJ _ DET NOUN ADJ _ DET PROPN CCONJ NOUN VERB PRON NOUN CCONJ _ DET NOUN PUNCT
Kount qader meme nkali el hayt toul el nhar	VERB ADJ ADV VERB DET NOUN ADJ DET NOUN
inchalah nerabho rabi m3a l'équipe l' équipe dialna	INTJ VERB PROPN ADP _ DET NOUN PRON
ana ngoul 3 / 1 pour l'algerie l' algerie et l'egypt l' egypt trouh ddez m3ahom	PRON VERB NUM PUNCT NUM ADP _ DET PROPN CCONJ _ DET PROPN VERB NOUN PRON
m3ak ya khadra whada w hada 3am 3amna	PRON INTJ PROPN _ CCONJ PRON NOUN NOUN
chkoun ma3embalouch f rap ani marhouch	ADV VERB ADP NOUN PRON VERB
wwwwwwwwwwwwwwwwww vive wald 3abbasse hadak ma ylik la ilah ila lah mouhaméd rasoul ilah ( sala élah 3alayhi wa salam )	INTJ VERB NOUN PROPN PRON PART VERB PART PROPN PART PROPN PROPN NOUN PROPN PUNCT VERB PROPN PRON CCONJ NOUN PUNCT
tu a raisons ben bouzid 3adou mayakrawech	PRON VERB NOUN PROPN PROPN ADV VERB
nimiro 2 nta mechhah ida malgawech win yroho yjo 3adna elbayadh el bayadh blad elkaram el karam	NOUN NUM PRON ADJ SCONJ VERB ADV VERB VERB PRON _ DET NOUN NOUN _ DET ADJ
ra7 ngoul les sujets l tefaw 3lihom do	VERB VERB DET NOUN PRON VERB PRON NOUN
3aandi 47 sana ya jolie sltp tabanayni je suis libre de tout engagement	PRON NUM NOUN INTJ ADJ INTJ VERB PRON VERB ADJ ADP DET NOUN
il faut dir que ils vont venir en algerie pour passe chahre al3asel al 3asel hna chtarahana fihoume yatzawjou wala yaga3dou	PRON VERB VERB SCONJ PRON VERB VERB ADP PROPN ADP VERB NOUN _ DET NOUN ADV VERB PRON VERB CCONJ VERB
salém 3alikoum moi je croie pas que un mouton coutera 8000dasa 8000 dasa	NOUN PRON PRON PRON VERB ADV SCONJ DET NOUN VERB _ NUM NOUN
merci zizo ntlbou haja menak bark ou9f m3a likip l ikip nta3na bark la zam wahd kima nta t3awnhoum merciiiiiiiiiiiiiiiiiiiiiiiiiiiii	INTJ PROPN VERB NOUN PRON ADV VERB ADP _ DET NOUN NOUN ADV VERB X NOUN SCONJ PRON VERB INTJ
rabi yijib elkhir el khir laldjami3e l al djami3e nchallah w li tal3ab mlih tarbah bonne chance pou tout	PROPN VERB _ DET NOUN _ ADP DET NOUN INTJ CCONJ PRON VERB ADJ VERB ADJ NOUN ADP PRON
c'est c' est des barbares !!! ils sont pire que des animaux !! h'sabehoum 3ande rabi k'bir !!!	_ PRON VERB DET NOUN PUNCT PRON VERB ADJ SCONJ DET NOUN PUNCT NOUN ADP PROPN ADJ PUNCT
khtouna ma z3aka wa tbahdayel	VERB PART NOUN CCONJ NOUN
Ya jma3a sahha f'tourkem	INTJ NOUN NOUN NOUN
nakrah firanca lakin lakin rahi blad 3adel hak nhab ljazair l jazair lakin rahi blad dalm wa hakra ben 3ammis	VERB PROPN CCONJ CCONJ VERB NOUN ADJ NOUN VERB _ DET PROPN CCONJ VERB NOUN NOUN CCONJ ADJ PROPN PROPN
allah la trba7kem chanchftona 3aib 3likem 7na 7aja mawslnaha mn hadi l 3atab	PROPN PART VERB VERB NOUN PRON PRON NOUN VERB ADP PRON DET NOUN
wladna ma ymoutouche 3la jal el balon ntouma koul 3am 3andkom 5 morts si ce n'est n' est pas plus	NOUN PART VERB ADP NOUN DET NOUN PRON DET NOUN PRON NUM NOUN SCONJ PRON _ ADV AUX ADV ADV
inchallah yet3allem le control bark	INTJ VERB DET NOUN ADV
vive mouloudia ni 3anger ni mess3oudi cest c est le mouloudia ki reste	VERB PROPN ADV PROPN ADV PROPN _ PRON VERB DET PROPN PRON VERB
w kayen wahd okhor yal3ab fi la france ( poste 2 ) mlih bel bezaf nssit esmou	CCONJ VERB NOUN ADJ VERB ADP DET PROPN PUNCT NOUN NUM PUNCT ADJ ADP ADV VERB NOUN
makhloufa nchalah lmara l mara djaya w enchala yedou titre hed el3am el 3am	ADJ INTJ _ DET NOUN ADJ CCONJ INTJ VERB NOUN PRON _ DET NOUN
salut cava moi sofiane nchalahe alrabita al rabita tnahi matche 3awiklo avec hammerawa ou mco	INTJ INTJ PRON PROPN INTJ _ DET PROPN VERB NOUN ADJ ADP PROPN CCONJ PROPN
natamana lho atwfik a twfik wa ramadane mobarik likole elcha3be el cha3be elisalamia el isalamia djami3a	VERB PRON _ DET NOUN CCONJ NOUN ADJ ADV _ DET NOUN _ DET ADJ ADV
la tassoubou al3arab al 3arab liana arassoul a rassoul 3arabi wa layssa djazairi itakou allah fi ma takouloune	PART VERB _ DET NOUN SCONJ _ DET NOUN NOUN CCONJ PART NOUN VERB PROPN ADP PRON VERB
hbabek nta ya saheb ta3liq 1 hna les berberes ma 3endna hetta 3alaqa m3ahoum ncher ya chourouk lelmarra l el marra lwla l wla	NOUN PRON INTJ NOUN NOUN NUM PRON DET NOUN PART PRON ADV NOUN PRON VERB INTJ PROPN _ ADP DET NOUN _ DET ADJ
sa7 sa7 ani 7ab dorka n7areb belkatiba be l katiba	ADJ ADJ PRON VERB ADV VERB _ ADP DET NOUN
aben 3amiiiiii les dinossors 3aychin m3ana wa hna ma3labalnach !!!!!	NOUN NOUN DET NOUN ADJ PRON CCONJ PRON NOUN PUNCT
wach kaina 3andkom 7ta ntoma vil de casablanca !!!!!!!!!!!!!!!!!!!!!!!!!!!!!!	PRON VERB PRON ADP PRON NOUN ADP PROPN PUNCT
je suis en classe de 3as philo je sais pas pandant les axamenes l'ifassure l' ifassure au le corecteure	PRON VERB ADP NOUN ADP NOUN NOUN PRON VERB ADV ADV DET NOUN _ DET NOUN CCONJ DET NOUN
yastahlou dhad lebnet le bnet puisque tama3in en plus ikhalfou echar3 e char3 el3adet el 3adet	VERB DET _ DET NOUN SCONJ ADJ ADP ADV VERB _ DET NOUN _ DET NOUN
oui kayana menaha ana 3ayach f doha les algerienes ghir jayabinaha tahawwass z shopinng	INTJ VERB PRON PRON ADJ ADP PROPN DET NOUN PART VERB NOUN X NOUN
ya jma3a mn hakkom thadjrou mais ma triskiwch	INTJ NOUN ADP NOUN VERB CCONJ PART VERB
ya wadi 3andek el ma3rifa ou la carte ta3 el 3asker takhdem ma3ndekche roh kayal el hyoute wala ahrag	INTJ NOUN PRON DET NOUN CCONJ DET NOUN ADP DET NOUN VERB VERB VERB ADJ DET NOUN CCONJ VERB
marhaban bika fi baladek aldjazayer al djazayer w3achet w 3achet anachidoka ya yousef	INTJ PRON ADP NOUN _ DET PROPN _ CCONJ VERB NOUN INTJ PROPN
ida jabou 9050 3lah ma t3awnohomch w tal3ohom hak bah yfawtou l3otla l 3otla bien waka normale wala machi normal	SCONJ VERB NUM ADV PART VERB CCONJ VERB PRON ADP VERB _ DET NOUN ADV ADV ADV CCONJ PART ADV
bon débarra on a plus besoin d'un d' un voyou comme toi aya rouh tahbi 3and papak heddad!	ADJ NOUN PRON VERB ADV NOUN _ ADP DET NOUN ADP PRON INTJ VERB VERB ADP NOUN PROPN
salam marhba bkhoutna b khoutna les marocain incha'Allah tkoun rouh reyadia 3aliya wa rabah mbrouk 3lih good luck	INTJ INTJ _ ADP NOUN DET NOUN INTJ VERB NOUN ADJ ADJ CCONJ NOUN ADJ PRON ADJ NOUN
l'algerie l' algerie tam3a trouh a la coupe des mondes	_ DET PROPN ADJ VERB ADP DET NOUN ADP NOUN
walou mamnu3 etadjamou3at e tadjamou3at rana fi halat etawari e tawari wa ila la% la % DE VOTE IL VA DEPASSE 13% 13 %	PRON ADJ _ DET NOUN VERB ADP NOUN _ DET NOUN CCONJ PART _ DET NOUN ADP NOUN PRON VERB VERB _ NUM NOUN
ya solo malgre haka bassah ya3djabni kire mine alhokame al hokame al3arabe al 3arabe	INTJ PROPN ADP PRON CCONJ VERB ADJ ADP _ DET NOUN _ DET ADJ
inchallah la victoire fi setif el3ali el 3ali	INTJ DET NOUN ADP PROPN _ DET ADJ
merci pour toutes les recettes j'attend j' attend tj le mkhabez le baklawa et les k3ik3atese	INTJ ADP ADJ DET NOUN _ PRON VERB ADV DET NOUN DET NOUN CCONJ DET NOUN
eeeeeehhhhh at3allam ya solo	INTJ VERB INTJ PROPN
3andna ghir lharga l harga	PRON PART _ DET NOUN
djha wellah 3andak hak hadak fare3 chrol	PROPN INTJ PRON NOUN PRON ADJ NOUN
c'est c' est tout c pas assez il derait etre condanné a mort in hiya el houkm ba chari3a ???????	_ PRON VERB PRON VERB ADV ADV PRON VERB VERB ADJ ADP NOUN SCONJ PRON DET NOUN ADP NOUN PUNCT
dem 3ad yesil o kheraj 7eta men khechamha	NOUN VERB VERB CCONJ VERB ADP ADP NOUN
w sur maskouna wela 9asha jenn bel b el mess regdoha	CCONJ ADV ADJ CCONJ VERB NOUN _ ADP DET NOUN VERB
la hawla wa la kawata ila bi-allah bi- allah wa lan tarda 3alykoum elyahoud el yahoud wala enaasara e naasara hata tatabi3ou milatohoum ellah yadina inchallah	PART NOUN CCONJ PART NOUN PART _ ADP PROPN CCONJ PART VERB PRON _ DET NOUN CCONJ _ DET NOUN ADV VERB NOUN PROPN VERB INTJ
elhamdolah 3la slamatkom inchallah yba3ad 3lina l3in l 3in hna les algeriens	INTJ ADP NOUN INTJ VERB PRON _ DET NOUN PRON DET NOUN
Salem 3alaikom occupe toi de l'équipe l' équipe de ton pays et laissez nous tranquille on a un mondial à jouer	NOUN PRON VERB PRON ADP _ DET NOUN ADP DET NOUN CCONJ VERB PRON ADJ PRON VERB DET NOUN ADP VERB
si bien sur ki karbou el intikhabat houwa rahou ydir hakda bash y3awdou yzidoulou 3ouhda mais rahou yahlam w el jazayrin fi franca rahoum doula hna loukan nhabou nodou nkharbouha 1 2 3 viva la lgerie	PRON ADV ADV ADV VERB DET NOUN PRON VERB VERB PRON SCONJ VERB VERB NOUN CCONJ VERB VERB CCONJ DET NOUN ADP PROPN VERB NOUN PRON SCONJ VERB VERB VERB INTJ INTJ INTJ VERB DET PROPN
avec les vertes moch 7at2dar tighamth 3ynik allez les vertes nchalah la coupe de monde zakara f l3adyan l 3adyan w soutou l egypt bye	ADP DET PROPN PART VERB VERB NOUN VERB DET PROPN INTJ DET NOUN ADP NOUN ADV ADP _ DET NOUN CCONJ ADV DET PROPN INTJ
amroune aw fi CSC en plus tab jnanou ma3adna mandirou bih 7anouni	PROPN INTJ ADP PROPN ADP ADV VERB NOUN ADP VERB PRON NOUN
yehadro al 2ayate tgoul yahder ghir b al 3ibriya	VERB DET NOUN VERB VERB PART ADP DET NOUN
les canons jayin mlarge m large w napalm menhom kharej	DET NOUN ADJ _ ADP NOUN CCONJ NOUN PRON ADJ
sa nara mada sataf3al bi idn Allah sawfa yafta7 al moslimeen europa	VERB X ADV VERB ADP NOUN PROPN PART VERB DET NOUN PROPN
tu é vraiment con mon frére essade el quatari ana kan y3aytouli manel3ebche fihblade fih blade miki blad ta3 tiki blad kolech fau kolech fiha mfabriki allah yehdina adjma3ine	PRON VERB ADV ADJ DET NOUN PROPN DET ADJ PRON VERB VERB VERB _ ADP NOUN PROPN NOUN ADP NOUN NOUN PRON ADJ PRON PRON VERB PROPN VERB ADJ
ben 3aljiya a pris deux cartons jaune à la conne	PROPN PROPN AUX VERB DET NOUN ADJ INTJ DET ADJ
min fzdhlikoum hal hounaka majal lilbanat li l banat wa kayfa wa mata yatim attasjil a ttasjil arjoukoum afidouni 3abra rimabouchawi@yahoofr	ADP NOUN ADV ADV NOUN _ ADP DET NOUN CCONJ ADV CCONJ ADV VERB _ DET NOUN VERB VERB ADP PROPN
hade bnadam ma33andouche mach ariere capable ya9tol ga3 les libyen allah yastore	PRON NOUN ADP NOUN ADJ ADJ VERB ADJ DET NOUN PROPN VERB
irouh 3and sarkouzi ya3tilou l'agenda l' agenda li yamchi biha	VERB ADP PROPN VERB _ DET NOUN PRON VERB PRON
vive lharaga l haraga vive tiaretia hadik marahich blad mabghinach n3icho fi bladkom blad lem3aref le m3aref blad lhogra l hogra hnaya la wraki la walo besah rana bien makanch hogra	VERB _ DET NOUN VERB NOUN PRON VERB NOUN VERB VERB ADP NOUN NOUN _ DET NOUN NOUN _ DET NOUN PRON DET NOUN PART PRON CCONJ VERB ADV VERB ADJ
de toute facon lmahaliyeen l mahaliyeen kheer manhom la houma khassreen khassreen ki l3ada l 3ada	ADP DET NOUN _ DET ADJ ADJ PRON PART PRON ADJ ADJ ADP _ DET NOUN
3am jay t3awed thawad bah trbah dakhel w bara wa tklassi 2 eme	NOUN ADJ VERB VERB ADP VERB ADJ CCONJ ADJ CCONJ VERB NUM ADJ
saha ennoum en noum ya saadane ki tel3ab la defense kifmah rah tmarki les buts ? oula yenzel men esmaa e smaa	INTJ _ DET NOUN INTJ PROPN ADV VERB DET NOUN ADV VERB VERB DET NOUN PUNCT CCONJ VERB ADP _ DET NOUN
hram 3alikoum karahtou la jeunesse fi koulch	ADJ PRON VERB DET NOUN ADP PRON
achebale a chebale al oma fikera bien est vive boutafalika avec l alger ma3a ma7iyati	_ DET NOUN DET NOUN NOUN ADV CCONJ VERB PROPN ADP DET PROPN ADP NOUN
makan equipe nationale wala wa la hom yahzanoun ya lem3askri l em3askri allah yarhmek ya saadan	VERB NOUN ADJ _ CCONJ PART PRON VERB INTJ _ DET NOUN PROPN VERB INTJ PROPN
s7aybi chkoun ana ? lotfi double kanon	NOUN ADV PRON PUNCT PROPN PROPN PROPN
les Égyptiens sont les amis des sionistes qui gèrent le monde entier donc les sanctions de la FIFA seront bardan wa salamen 3ala el massriyin	DET NOUN VERB DET NOUN ADP NOUN PRON VERB DET NOUN ADJ CCONJ DET NOUN ADP DET PROPN VERB ADV CCONJ ADV ADP DET NOUN
elah la trebahkoum tebkiw e3la el kouba tedrah ssn pitier ou mab9ach fikoum el hal e3la les squipes dyal louest l ouest ASMO MCO BELABESS MASCARA WAT besah ma3lihech ham djau chwakerkoum y al 3assima ULTRA EL HARRACH	PROPN PART VERB VERB ADP DET NOUN VERB PROPN NOUN CCONJ VERB PRON DET NOUN ADP DET NOUN ADP _ DET NOUN PROPN PROPN PROPN PROPN PROPN CCONJ VERB PRON VERB NOUN INTJ DET NOUN ADJ DET PROPN
me3ak ya el khadra deri hala et vive l algerie	PRON INTJ DET PROPN VERB NOUN CCONJ VERB DET PROPN
in cha ALLAH narbhou w nadouh m3ana la baldo fi trikna	INTJ X X VERB CCONJ VERB PRON DET NOUN ADP NOUN
Arwah n3almek tarbah des millions en fraction	VERB VERB VERB DET NOUN ADP NOUN
salam alikoum marhaban bik fi aljazayer al jazayer mais nahanou man3tberoukch 3alim wa la haja kabira nata iansan normal	INTJ PRON INTJ PRON ADP _ DET PROPN CCONJ PRON VERB NOUN CCONJ PART NOUN ADJ PRON NOUN ADJ
ya y a pas que se jeune la rabi m3ah meme tout l'agarie l' agarie ouled lahram la hram ma3na	_ PRON VERB ADV SCONJ DET ADJ PRON PROPN PRON ADV ADJ _ DET PROPN NOUN _ DET NOUN PRON
roh takoule lkhobze l khobze fi bladek wela ta3arfou tahagrou ghire el mouslimine ms hna rak fi DZAYER matensach	VERB VERB _ DET NOUN ADP NOUN CCONJ VERB VERB PART DET NOUN CCONJ ADV VERB ADP PROPN VERB
vive jsk hathe l3ame l 3ame nchallah championat et la coupe dafrique d afrique zkara fi sarar	VERB PROPN PRON _ DET NOUN INTJ NOUN CCONJ DET NOUN _ ADP PROPN ADV ADP PROPN
ziani ahsan la3ib fi el3alem el 3alem	PROPN ADJ NOUN ADP _ DET NOUN
goli berka walidih wache kan fi balhom	VERB ADV NOUN ADV VERB ADP NOUN
3lah ki yjiw yal3bou m3ana ywaliw m3awkin	ADV PRON VERB VERB PRON VERB NOUN
Li darou had l’affaire l’ affaire am 3aychine f l'europe l' europe b3ad	PRON VERB PRON _ DET NOUN VERB VERB ADP _ DET PROPN ADJ
3aybe 2 manda bezaf 3lik	NOUN NUM NOUN ADV PRON
makan lah telomni yana lom denia li rahi t3ayef	VERB NOUN VERB PRON VERB NOUN PRON VERB VERB
oui le Maroc aktar jahiziya li had tasfiyat la 3ala lmostawa l mostawa tandimi	INTJ DET PROPN ADV ADJ ADP DET NOUN PART ADP _ DET NOUN NOUN
salut te rabi yahdina et 3adama alaho ajrakom	INTJ X PROPN VERB CCONJ VERB PROPN NOUN
je taime t aime madjid nchalah tkon dima fal3ali f al 3ali wdima w dima mcharaf bladna	PRON _ PRON VERB PROPN INTJ VERB ADV _ ADP DET NOUN _ CCONJ ADV ADJ NOUN
ma3andhom ma ydirou mais lhadj 3issa a3tolo 7ako hada makan	ADP PART VERB CCONJ PROPN PROPN VERB NOUN PRON VERB
vive l algerie vive l algerie inchallah ya rabi tba3ed 3lina ekl 3ainnnnnnne	VERB DET PROPN VERB DET PROPN INTJ INTJ PROPN VERB PRON ADV NOUN
meskin ella3ib el la3ib elmahali el mahali 3afsou 3lih f hed lebled le bled c unjuste kesk il arrie	ADJ _ DET NOUN _ DET ADJ VERB PRON ADP PRON _ DET NOUN VERB ADJ ADV PRON VERB
rabi ykoun m3akoum khawti ida nakaskoum joueur rani hna gool w tala3 defanseur attaqand kolach thatni 3la jarh nabra thalaw f rwahkoum @+	PROPN VERB PRON NOUN SCONJ VERB NOUN VERB ADV VERB CCONJ VERB ADJ ADJ PRON VERB ADP NOUN VERB VERB ADP NOUN INTJ
nchalah yrouh ilverpool m3a le magic madjid bougherra	INTJ VERB PROPN ADP DET NOUN PROPN PROPN
madam m3aya wlad cha3b dima bien bien bien	ADV PRON NOUN NOUN ADV ADV ADV ADV
lmoral l moral ta3i à fond dima bien bien bien	_ DET NOUN PRON ADP NOUN ADV ADV ADV ADV
Mala jib l’uranium l’ uranium nsépari les atomes	ADV VERB _ DET NOUN VERB DET NOUN
klami sa7 yweli klach ysyib 30 tal9a fi seconde	NOUN ADJ VERB NOUN VERB NUM NOUN ADP NOUN
nchalah la victoire fi sétif l3ali l 3ali ESS2CABA1 ESS 2 CABA 1	INTJ DET NOUN ADP PROPN _ DET ADJ _ PROPN NUM PROPN NUM
CHAOUCHI un vrai homme ? w rana m3ak	PROPN DET ADJ NOUN PUNCT CCONJ VERB PRON
vive lalgerie l algerie w mabrouk 3la chaouchi a raj3a	VERB _ DET PROPN CCONJ INTJ ADP PROPN DET NOUN
3ajbeti ta3 weled ziani achhare men el wazire	VERB ADP NOUN PROPN ADJ ADP DET NOUN
bsahtak win rah lmouchkal l mouchkal com quoi kartikom wa3ar	INTJ ADV VERB _ DET NOUN SCONJ PRON NOUN ADJ
reja3na al jahiliya kima kano yegatlo weladhom	VERB DET NOUN ADP VERB VERB NOUN
houma wladhoum ga3 rahoum f'europa f' europa enchalah tebra ya el anabi	PRON NOUN ADV VERB _ ADP PROPN INTJ VERB INTJ DET ADJ
hna malfin brabi b rabi yakhlef makayn el ness ay tatssameh e rbi i3afina men hath el mardh	PRON ADJ _ ADP PROPN VERB NOUN DET NOUN VERB VERB CCONJ PROPN VERB ADP PRON DET NOUN
hassbouan allah wa ni3ama el wakill fikoum ya houkam el djazire	VERB PROPN CCONJ NOUN DET NOUN PRON INTJ NOUN DET PROPN
messi yal3ab fi maticohhhhhhhhhhhhh	PROPN VERB ADP NOUN
ye rania bent elbordj el bordj raki tam3a beze la coupe rahi staifia w rabi kbirla	INTJ PROPN NOUN _ DET PROPN VERB ADJ ADV DET NOUN VERB NOUN CCONJ PROPN ADJ
Jamais yahkmouni khatak fi jibi el chakshiate	ADV VERB ADV ADP NOUN DET NOUN
el jazeeara rabi yehdiha kafaki mena el fitna w 3alji el mawadi3e b wajhe akhlaki	PROPN PROPN PROPN VERB VERB ADP DET NOUN CCONJ VERB DET NOUN ADP NOUN ADJ
A3oudou billahi bi llahi mina Chitan rajim Yerfa3ou allahou alathina amanou minkoum oua lathina outou al3ilma al 3ilma daragate Sadakou allahou al3athim al 3athim	VERB _ ADP PROPN ADP PROPN ADJ VERB PROPN PRON VERB PRON CCONJ PRON VERB _ DET NOUN NOUN VERB PROPN _ DET ADJ
nasse raha f la technologie HD wahna wa hna rana 3ada netmenaw une chaine sportive	NOUN VERB ADP DET NOUN NOUN _ CCONJ PRON VERB NOUN VERB DET NOUN ADJ
vive mco il reste un match est tal3a national 1vive 1 vive mouloudia d'oran d' oran li ma brach ybat yekhdech	VERB PROPN PRON VERB DET NOUN VERB NOUN ADJ _ NUM VERB PROPN _ ADP PROPN PRON PART VERB VERB VERB
el t3alik rakam 5 in aradat el islam edhab el soudia wala iran w3alh troh le france	DET NOUN NOUN NUM SCONJ VERB DET NOUN VERB DET PROPN CCONJ PROPN ADV VERB DET PROPN
Bienvenue en Algérie !!! tu vas voir el3ajayeb el 3ajayeb w- elgharayeb el gharayeb que tu n'aurais n' aurais jamais vues aux Etats Unis	INTJ ADP PROPN PUNCT PRON VERB VERB _ DET NOUN CCONJ _ DET NOUN SCONJ VERB _ ADV VERB ADV VERB ADP PROPN PROPN
wache raykome nhare vote ndiro photo de batata khire mane mokata3a	PRON NOUN NOUN NOUN VERB NOUN ADP NOUN ADJ ADP NOUN
je suis sur loukan l3ab chawchi manakhasrouch b 3 - 0	PRON VERB ADJ SCONJ VERB PROPN VERB ADP NUM PUNCT NUM
soit que vous etes vraiment chirurgien mais apres 13ans 13 ans d'etudes d' etudes vous ne savez pas l'ecrire l' ecrire et c'est c' est une grande hante !!!!!! sobhan llah l3adim l 3adim les gens sont complétement fous ya rabbi ahdi les algériens w radalhom la3kal l a3kal ya rab AMINE	VERB SCONJ PRON VERB ADV NOUN CCONJ ADV _ NUM NOUN _ ADP NOUN PRON ADV VERB ADV _ PRON VERB CCONJ _ PRON VERB DET ADJ NOUN PUNCT NOUN PROPN _ DET ADJ DET NOUN VERB ADV ADJ INTJ PROPN VERB DET NOUN CCONJ VERB _ DET NOUN INTJ PROPN INTJ
Yahsabouna des kobays , lebled le bled welet laboratoire	VERB DET NOUN PUNCT _ DET NOUN VERB NOUN
o mi walah ma nakhdam 3and al3arbi al 3arbi kahl aras a ras w yarnini w al3askar al 3askar manfatou ok merci	CCONJ CCONJ INTJ PART VERB ADP _ DET NOUN ADJ _ DET NOUN CCONJ VERB CCONJ _ DET NOUN VERB INTJ INTJ
malgre had skhana w rabi soubhaonou 3atina sbar hadi rahma man 3and allah rabi ykadarna w ytkabal mana nchaalh	ADV PRON NOUN CCONJ PROPN NOUN VERB NOUN PRON NOUN ADP ADP PROPN PROPN VERB CCONJ VERB PRON INTJ
ViVeeeeeeeeeeeeeeee mouloudia pour toujour inchallah had 3am lina mouwafekkkk	VERB PROPN ADP ADV INTJ PRON NOUN PRON ADJ
ycombati la misere li las9at fina welat kiste	VERB DET NOUN PRON VERB PRON VERB NOUN
Assalamou A salamou 3aleikom	_ DET INTJ PRON
nsta3rfe bikoum mes loukane jate al 3annaba na3mlou fiha akterre men haka	VERB PRON CCONJ SCONJ VERB DET PROPN VERB PRON ADJ ADP PRON
awah ya chriki michi berk houwa li derha wifek stif tanik dertha tadamounen ma3a filistin	INTJ INTJ NOUN PART ADV PRON PRON VERB PROPN PROPN ADV VERB ADV ADP PROPN
salam maaliche hadi ghir 3ain darbet les algeriens et c normal apres se qu'on qu' on fait et tt le monde parle ya rabi ba3ad al 3ainine alina ya rabii onr two tre viva lalgerie l algerie et vive tt les algerien every where and every when thanks	INTJ INTJ PRON PART NOUN VERB DET NOUN CCONJ VERB ADJ ADV PRON _ PRON PRON VERB CCONJ ADJ DET NOUN VERB INTJ NOUN VERB DET NOUN PRON INTJ NOUN INTJ INTJ INTJ VERB _ DET PROPN CCONJ VERB ADV DET NOUN ADV X CCONJ ADV X INTJ
vive Algérie malgré tous et j'esper j' esper kon va battre surtout egypte 3ayana welade chatahate	VERB PROPN ADP PRON CCONJ _ PRON VERB PRON VERB VERB ADV PROPN ADJ NOUN PROPN
ya el khawana ya yahoud tahya filastine wa tahya el jazair ya kilab el 3arab	INTJ DET NOUN INTJ NOUN VERB PROPN CCONJ VERB DET PROPN INTJ NOUN DET NOUN
1 2 3 vive l`algerie l` algerie ou inchalllah ga3 tabrwe bach tefrouhona rana me3akoum ya khedra	INTJ INTJ INTJ VERB _ DET PROPN CCONJ INTJ ADV VERB ADV VERB VERB PRON INTJ PROPN
rabi yahmi el blad wa el ch3ab et vive l'armée l' armée algerienne	PROPN VERB DET NOUN CCONJ DET NOUN CCONJ VERB _ DET NOUN ADJ
nahno fi lahaye la haye fi blad lgorba l gorba 3andna alhak al hak fi parabor wa la ntoma fi lblad l blad horiya wah al horiya	PRON ADP _ DET PROPN ADP NOUN _ DET NOUN PRON _ DET NOUN ADP NOUN CCONJ ADV PRON ADP _ DET NOUN NOUN INTJ DET NOUN
maroc wa3ar bazaf	PROPN ADJ ADV
idha mayal3abch chawchi tetulaire manatfarch la coupe d'afrique d' afrique	SCONJ VERB PROPN NOUN VERB DET NOUN _ ADP PROPN
hna houma chwaker el 3asima wa mazal dalat saliha(crb) vive bvb	PRON PRON ADJ DET NOUN CCONJ VERB VERB PROPN VERB PROPN
kariMatmour four bezaf w nchalah narbhou w ngalifou egypt equipe faible 3ayb bach trouh l mandila	PROPN ADJ ADV CCONJ INTJ VERB CCONJ VERB PROPN NOUN ADJ NOUN ADP VERB DET NOUN
vive MCO nchalah tal3a hada l3am l 3am vive belgaid et bel-air	VERB PROPN INTJ NOUN PRON _ DET NOUN VERB PROPN CCONJ PROPN
ana kandan had lmosalsalate l mosalsalate hiya tafwij 3la mogtama3 wach had lmogtama3 l mogtama3 3aych fi lmachakil l machakil wi zid hta lmachakil l machakil ta3 phelesten machi ma39ol phelesten rah bkhaha allah ichofha mahtala	PRON VERB PRON _ DET NOUN PRON NOUN ADP NOUN ADV PRON _ DET NOUN ADJ ADP _ DET NOUN CCONJ VERB ADV _ DET NOUN ADP PROPN PART ADJ PROPN VERB VERB PROPN VERB ADJ
nchalah la victoire fi stif l3ali l 3ali	INTJ DET NOUN ADP PROPN _ DET ADJ
rendez vous 2m1 3andna alah yj3al el khir	VERB PRON ADV PRON PROPN VERB DET NOUN
vriament ta3jabni bezzaf ou rabi 3aounak	ADV VERB ADV CCONJ PROPN VERB
Lhih benesba be nesba lihoum hnaya experience	ADV _ ADP NOUN PRON PRON NOUN
Nhassél fih koulech , nghorou ghir b la jet-set	VERB PRON PRON PUNCT VERB PART ADP DET PROPN
salam 3likoum ta3alim on algerie makayan walou kolhaja balahabe haka w madabihe ben bouzid ina	INTJ PRON NOUN ADP PROPN VERB PRON PRON NOUN DET CCONJ ADV PROPN PROPN X
ya wdi lhaw ghir feljazaiar f el jazaiar khalina man madrid raha b3ida 3likame 3andha li yabghouha wlad bladha ntouma wlad oran w alger w chlef lhaw ghir tama	INTJ NOUN PRON PART _ ADP DET PROPN VERB ADP PROPN VERB ADJ PRON PRON PRON VERB NOUN NOUN PRON NOUN PROPN CCONJ PROPN CCONJ PROPN PRON PART VERB
hada 3am championi vive aso	PRON NOUN NOUN VERB PROPN
ina lilah li lah wa ina ilayhi 3aji3oune rabi yarhamha wa isabar sa famille	VERB _ ADP PROPN CCONJ VERB PRON ADJ PROPN VERB CCONJ VERB DET NOUN
nesta3raf bik khouya solo yatik elsaha el saha w rani m3ak 200% 200 % fi wach golt galo zidan hahahahahha	VERB PRON NOUN PROPN VERB _ DET NOUN CCONJ VERB PRON _ NUM NOUN ADP PRON VERB VERB PROPN INTJ
éh le peuple arreté arreté ce n'est n' est pa pour vous cette Nansi 3adjrèm c'est c' est pour lé enfants de nos ééhh wi ac lé risk k y on a au liban vau mieu l amené ici pour fair plaisir au enfant de nos ( devinette	INTJ DET NOUN VERB VERB PRON _ ADV VERB ADV ADP PRON DET PROPN PROPN _ PRON VERB ADP DET NOUN ADP DET INTJ INTJ ADP DET NOUN SCONJ PRON PRON VERB ADP PROPN VERB ADV DET VERB ADV ADP VERB NOUN ADP NOUN ADP DET PUNCT NOUN
stp stp stp saadane la3abe meghni asasi wa la ya3tik saha	INTJ INTJ INTJ PROPN VERB PROPN ADJ CCONJ PROPN VERB NOUN
wach men 2akhela9 , ra7o wakhdo al makhlo9	DET ADP NOUN PUNCT VERB VERB DET NOUN
sa3dane entraineur ta3 la defense wellah ma tchoufou el rebh m3ah	PROPN NOUN ADP DET NOUN INTJ PART VERB DET NOUN PRON
allah ghaleb rana obligé bah nakhadmou m3ahom	PROPN ADJ VERB ADJ ADP VERB PRON
makanch lamane l amane il faut une anquete detailler pout etre djbou m3ahom el mard anflownza khanzir oula djawassiss chkoun chaf	VERB _ DET NOUN PRON VERB DET NOUN ADJ ADV X VERB PRON DET NOUN NOUN NOUN CCONJ NOUN PRON VERB
c vrais haj issa 3andou blastou 123 vive algerie	VERB ADJ PROPN PROPN PRON NOUN INTJ VERB PROPN
W ana ani blanc pour le moment j’ai j’ ai pas le temps	CCONJ PRON PRON ADJ ADP DET NOUN _ PRON VERB ADV DET NOUN
vive bougera enchalah el3ame el 3ame eljaye el jaye fe el barca fi plaset markas	VERB PROPN INTJ _ DET NOUN _ DET ADJ ADP DET PROPN ADP NOUN ADJ
tahya ragan sahera m3a les scorpions	VERB PROPN NOUN ADP DET NOUN
ziani mal3abech fi l match ta3 lbartahe l bartahe pour qoi ???	PROPN VERB ADP DET NOUN ADP _ DET NOUN ADV X PUNCT
la hawla wa la kowata ila bilah bi lah atamana ana alah yatihim bi zilzal 3adim	PART NOUN CCONJ PART NOUN PART _ ADP PROPN VERB SCONJ PROPN VERB ADP NOUN ADJ
Mabrouk ya lafhal wa allah afarrah omimtek ali sahrat 3alik hadou awlad abladi aljazaeer natalblou rabi moustakbal hafal bin najah wa houwa Mafkhra L 'al jazaeer	INTJ INTJ NOUN CCONJ PROPN VERB NOUN PRON VERB PRON PRON NOUN NOUN PROPN VERB PROPN NOUN ADJ ADP NOUN CCONJ PRON NOUN ADP PROPN PROPN
inchaa allah nafouz 3ala zombia zkara fi elmisryine el misryine inchaa allah l'algerie l' algerie sera mondial et au can inchaa allah	INTJ X VERB ADP PROPN ADV ADP _ DET NOUN INTJ X _ DET PROPN VERB ADJ CCONJ ADP PROPN INTJ X
hado ge3 ma 3amrolakch 3aynek	PRON ADV PART VERB NOUN
anetoma tani ma3andekom hata ma3ena echorok	PRON ADV ADP ADV NOUN PROPN
chekon ali galalkom kesna chirine hada makas al3amya al 3amya rir alkehel al kehel	ADV PRON VERB VERB PROPN PRON NOUN _ DET ADJ PART _ DET ADJ
li ktab article nta3 cab w nahd raho la 3alaka	PRON VERB NOUN ADP PROPN CCONJ PROPN VERB PART VERB
germany ghab hasak hsabtak hragt rak fi talyan wala la france khaliwna n3aydo tronkil yarham waldikom	PROPN VERB NOUN VERB VERB VERB ADP PROPN CCONJ DET PROPN VERB VERB ADJ VERB NOUN
li yedih haj aissa fi un mois ymechi equipe de judo fi 3am	PRON VERB PROPN PROPN ADP DET NOUN VERB NOUN ADP NOUN ADP NOUN
saifi porte malheur !! svp !! il faut pas le limoger ! ba3ad a3lina lebla le bla	PROPN VERB NOUN PUNCT INTJ PUNCT PRON VERB ADV PRON VERB PUNCT VERB PRON _ DET NOUN
vive chawchi 3andna tadjar khyr men yebda	VERB PROPN PRON PROPN ADJ ADP PROPN
ana 3andi edeme e deme ( o- ) mais manmedche kouleche bedraheme be draheme 500 ml 100000 da buisnes is buisnes	PRON PRON _ DET NOUN PUNCT NOUN PUNCT CCONJ VERB PRON _ ADP NOUN NUM NOUN NUM NOUN NOUN VERB NOUN
assektouuuuuuuuuuu chrawkome bi 30 millioune fi echehar e chehar hada weche tesswa 3andkome edzayer e dzayer	VERB VERB ADP NUM NOUN ADP _ DET NOUN PRON PRON VERB PRON _ DET PROPN
alhamdou al hamdou lilah li lah 3ala salamatika ya rab wahid soufouf al mouslimin w al jazairin ya rab w vive bladi	_ DET NOUN _ ADP PROPN ADP NOUN INTJ PROPN VERB NOUN DET NOUN CCONJ DET NOUN INTJ PROPN CCONJ VERB NOUN
mais sa3dan dar la faut min dakhal saifi normalement ydakhal 3abdoun et boudabouz	CCONJ PROPN VERB DET NOUN ADV VERB PROPN ADV VERB PROPN CCONJ PROPN
el hamodoulilaaah li rabi el 3alamine wefekena djiche dialna 3ala hado atbaa3 ta3 les juifes	DET INTJ ADP PROPN DET NOUN VERB NOUN PRON ADP PRON NOUN ADP DET NOUN
3adi fi biladi mais les autre pays il sont jalou de nous psq on est les meiheur	ADJ ADP NOUN CCONJ DET ADJ NOUN PRON VERB ADJ ADP PRON SCONJ PRON VERB DET ADJ
rabi m3ak ya chikh saadan w rana m3akoum hata l la fin	PROPN PRON INTJ PROPN PROPN CCONJ VERB PRON ADP ADP DET NOUN
ya3tik saha ya sadane ki jite anta elle djayaire wala elle la3be mlihe nchalah n3atou triha elle masare	VERB NOUN INTJ PROPN ADV VERB PRON DET PROPN CCONJ DET NOUN ADJ INTJ VERB NOUN DET PROPN
Les postes , tonobilettes , lehwanets le hwanets w diar	DET NOUN PUNCT NOUN PUNCT _ DET NOUN CCONJ NOUN
hadi l3aklia l 3aklia kayena fi bladna bark mneh makench les moyens ou zid 3akliete les joueurs loceaux mbdela	PRON _ DET NOUN ADJ ADP NOUN ADV PRON VERB DET NOUN CCONJ VERB NOUN DET NOUN ADJ ADJ
ya cha3b mayanfa3 m3ah ni aant ni aprés	INTJ NOUN VERB PRON ADV ADV ADV ADV
lhaj l haj moussa moussa lhaj l haj en gros roh 3ageb l'armé l' armé w l'avenir l' avenir dirou a 40 ans	_ DET NOUN PROPN PROPN _ DET NOUN ADP ADV VERB VERB _ DET NOUN CCONJ _ DET NOUN VERB ADP NUM NOUN
vous avez signé Contrat Matel3abch brohak b brohak 3anbalek rak fi stif wela MCA wella JSK wella USMA	PRON VERB VERB NOUN VERB _ ADP NOUN NOUN VERB ADP PROPN CCONJ PROPN CCONJ PROPN CCONJ PROPN
3alach mandirouch match ta3 mahlyiane contre l'equipe l' equipe A nchoufou chkoun li yrabah we li yarbah yla3ab contre maroc	ADV VERB NOUN ADP ADJ ADP _ DET NOUN NOUN VERB ADV PRON VERB CCONJ PRON VERB VERB ADP PROPN
je souhaite el hidaya l omate mohamed salaalah sala alah 3alih wa salem	PRON VERB DET NOUN ADP NOUN PROPN _ VERB PROPN PRON CCONJ VERB
Le temps d’charger d’ charger les batterie w la retraite fi Paris	DET NOUN _ ADP VERB DET NOUN CCONJ DET NOUN ADP PROPN
tadahkou 3ala el massryinnes dahkou 3ala arwahkoum	VERB ADP DET NOUN VERB ADP NOUN
W n3adi meme l'Nice, l’ Nice , nakhdem m3a la mafia Russe	CCONJ VERB ADV _ ADP PROPN PUNCT VERB ADP DET NOUN ADJ
hahaha ikita3at al dzayer	INTJ NOUN DET PROPN
normal 3ankom al hak ya les medcins	ADJ PRON DET NOUN INTJ DET NOUN
je suis avec el mokata3a	PRON VERB ADP DET NOUN
fa wallahi la a3lamo ma youf3ali bi wa bikom	CCONJ INTJ PART VERB PART VERB PRON CCONJ PRON
elah la y3awed ywerina wejek la nta la li kifek	PROPN PART VERB VERB NOUN PART PRON PART PRON PRON
il faut mourad megheni yell3ab morad la3ib assasi wa ya3raf yal3ab	PRON VERB PROPN PROPN VERB PROPN NOUN ADJ CCONJ VERB VERB
vive canada pasport rouge nrouh wine nhab nwali chikour fu franca wahed ma yehdar m3aya	VERB PROPN NOUN ADJ VERB ADV VERB VERB ADJ ADP PROPN NOUN PART VERB PRON
Arabophone francophone ; qahera wella la sorbonne , rajel fihoum qoulli chkoun	ADJ ADJ PUNCT PROPN CCONJ DET PROPN PUNCT NOUN PRON VERB ADV
braka ellah fikou rebi yeoufe9ue m3akom vive les algerienne	VERB PROPN PRON PROPN VERB PRON VERB DET NOUN
lgoudam l goudam berk les verts tt lalgerie l algerie deriere vous w rabi m3ana	_ ADP NOUN ADV DET PROPN ADJ _ DET PROPN ADJ PRON CCONJ PROPN PRON
3awda maymouna	NOUN ADJ
De fondez votre cheikh contre alfirkha al firkha addala a ddala a chi3a arafida	VERB X DET NOUN ADP _ DET NOUN _ DET ADJ DET NOUN ADJ
3andek essah e ssah ya si HANECHI	PRON _ DET NOUN INTJ NOUN PROPN
hhhhhhhhhhhhhhhhhh 30 pour 100 agedlouna bel b el leghdeb 1ans 1 ans au homa yaghedbou a3lina yaw al 3ati rabi	INTJ NUM ADP NUM VERB _ ADP DET NOUN _ NUM NOUN CCONJ PRON VERB PRON INTJ DET ADJ PROPN
bonne chance algerie 123 vive algerie allez les veres rabi m3akom youcef maifi	ADJ NOUN PROPN INTJ VERB PROPN VERB DET PROPN PROPN PRON PROPN PROPN
saha ramdankoum wkoul w koul 3am wintouma w intouma bkhir b khir ;;; haba just ngoul ki 5jui ki tchaker ki hna ki lhih lmouhim l mouhim kifah tél3bou w lbaraka l baraka fi réjlikoum sa na n a rien avoire a voire avec le stad	NOUN NOUN _ CCONJ DET NOUN _ CCONJ PRON _ ADP NOUN PUNCT VERB ADV VERB ADP PROPN ADP PROPN ADP ADV ADP ADV _ DET ADJ ADV VERB CCONJ _ DET NOUN ADP NOUN PRON _ ADV VERB PRON _ ADP VERB ADP DET NOUN
sira3 3ala alrimal al rimal sehr schöne serie und super schauspieler et salut a tout les marocan	NOUN ADP _ DET NOUN ADJ PROPN NOUN CCONJ ADJ NOUN CCONJ NOUN ADP ADJ DET NOUN
ngolhom al islam macho 3ilm al khayal	VERB DET NOUN PART NOUN DET NOUN
khsara 3likom min yerboho tebrohom w min ykhasro t3ayerohom pffffffffffffffffffffffffff	NOUN PRON ADV VERB VERB CCONJ ADV VERB VERB INTJ
Pour le rafik d'EULMA d' EULMA je sais que rak hassed SETIF besah dirou 1 / 10 wach daret SETIF barakat 3alikom	ADP DET PROPN _ ADP PROPN PRON VERB SCONJ VERB ADJ PROPN CCONJ VERB NUM PUNCT NUM PRON VERB PROPN NOUN PRON
choufou rani dert el golavirage w sobte l'algerie l' algerie rabha 1 _ 0 tanzanie aya w morocco tekhser m3a l'afrique l' afrique de centre 1 - 0 w hna ki tjina l'afrique l' afrique de centre nerbhouha 3 _ 0 w hna nqualifou inchaellah goulou ammmmiiinnnn	VERB VERB VERB DET NOUN CCONJ VERB _ DET PROPN ADJ NUM PUNCT NUM PROPN ADV CCONJ PROPN VERB ADP _ DET PROPN ADP NOUN NUM PUNCT NUM CCONJ ADV ADV VERB _ DET PROPN ADP NOUN VERB NUM PUNCT NUM CCONJ PRON VERB INTJ VERB INTJ
goulou lheddaj l heddaj mayebkicha !!! kouba tal3at matwalicha !!! casse toi du foot balle ta t a pa de relation avc !!!!!! casse toi !!	VERB _ ADP PROPN VERB PUNCT PROPN VERB VERB PUNCT VERB PRON ADP NOUN X _ PRON VERB ADV ADP NOUN ADP PUNCT VERB PRON PUNCT
nasse 3aicha ou nass taicha cest c est l'étta l' étta de notre pauvre pays	NOUN ADJ CCONJ NOUN ADJ _ PRON VERB _ DET NOUN ADP DET ADJ NOUN
walah ghire 3ajab tous les algeriens devienne des conaiseure ds la foot yakhi chaab yakoul mayderanger	INTJ PART NOUN ADJ DET NOUN VERB DET NOUN ADP DET NOUN INTJ NOUN VERB VERB
m3a chrouke 3ichou la vei et la verita pas de khtheb m3a chrouke	ADP PROPN VERB DET NOUN CCONJ DET NOUN ADV ADP NOUN ADP PROPN
lraho khayef 3ala elkhima el khima nta3o yatleb fe najda men	VERB ADJ ADP _ DET NOUN PRON VERB DET NOUN ADP
salem pour moi nchoufe fih mliha bark wache tgoulou ya djma3a	NOUN ADP PRON VERB PRON ADJ ADV PRON VERB INTJ NOUN
3andek hak ya milat ta3mik 2 hadi hadra makanech kima tazawji b hbib 9alb sans chorot	PRON NOUN INTJ PROPN VERB ADP PRON NOUN VERB ADP VERB ADP NOUN NOUN ADP NOUN
l alegerie mabka fiha ghure sehab elderaham el deraham lihoma rahom 3aychun vive oropa	DET PROPN VERB PRON PART NOUN _ DET NOUN PRON VERB ADJ VERB PROPN
Ana mokhi khaméj mokhi m3amar be takhmam	PRON NOUN ADJ NOUN ADJ ADP NOUN
ziani neta for bezaftel3ab balon meliha + neta fehal ou tehab beladak merci karim	PROPN PRON ADJ ADV NOUN ADJ ADV PRON ADJ CCONJ VERB NOUN INTJ PROPN
el hamdou lilah li lah ya rabi alla 3awdat chawchi ouf maintenant je peu dormir tranquil mérci sa3dan	DET NOUN _ ADP PROPN INTJ PROPN ADP VERB PROPN INTJ ADV PRON VERB VERB ADJ INTJ PROPN
nkolak ya elchikh sa3dan wachrak tastana bach t3ayat la chadli blasto basigar ba sigar	VERB INTJ PROPN PROPN PRON VERB ADP VERB ADP PROPN NOUN _ ADP NOUN
rabi ikon am3akom ya alkhadra al khadra 1 2 3 vive a nous lesalgerien les algerien	PROPN VERB PRON INTJ _ DET PROPN INTJ INTJ INTJ VERB ADP PRON _ DET NOUN
pour le 10 3lach ntouma min waktach 3andkoum tarikh la jalousie	ADP DET PRON ADV PRON ADP NOUN PRON NOUN DET NOUN
lazam matmor yal3ab mafihach hadra khlass	VERB PROPN VERB ADP NOUN ADV
nahmed allah 3alla hadhihi alnajat al najat et tant pis pour la défaite	VERB PROPN ADP PRON _ DET NOUN CCONJ SCONJ ADV ADP DET NOUN
normalmon ya3admouh en plein air kima gal elimam el imam	ADV VERB ADP ADV NOUN ADP VERB _ DET NOUN
vive mca hada l3ame l 3ame 3amna vive touil champione mca	VERB PROPN PRON _ DET NOUN NOUN VERB ADJ NOUN PROPN
j'espere j' espere de bon coeur que ziani et meghani soient pret pour le mondial amin ya rabe el3alamin el 3alamin	_ PRON VERB ADP ADJ NOUN SCONJ PROPN CCONJ PROPN VERB ADJ ADP DET NOUN INTJ INTJ PROPN _ DET NOUN
bon je suis algerien ta3 bekri je veux dire 3akliya ta3 les vrais algeriens vraiment on s'est pas quoi faire de vivre chez el gaouri et de travailler chez lui c'est c' est impossible notre dignete nous permez pas de rester ici et voir el mounkar vraiment c'est c' est honteux quand est ce que on va changer cette mentalite croyez moi que les vrais algeriens sont pas comme ca c'est c' est carrement autre chose mais bon	ADJ PRON VERB NOUN ADP ADV PRON VERB VERB NOUN ADP DET ADJ NOUN ADV PRON VERB ADV PRON VERB ADP VERB ADP DET ADJ CCONJ ADP VERB ADP PRON _ PRON VERB ADJ DET NOUN PRON VERB ADV ADP VERB ADV CCONJ VERB DET NOUN ADV _ PRON VERB ADJ ADV VERB PRON SCONJ PRON VERB VERB DET NOUN VERB PRON SCONJ DET ADJ NOUN VERB ADV ADP PRON _ PRON VERB ADV ADJ NOUN CCONJ INTJ
dima tesra l ghalfohom f journal malayeka khatih	ADV VERB PRON VERB ADP NOUN NOUN ADJ
ations arabes a commencé pare l 'Algérie Suiwez donc la méthode algérienne et ous werrez comment les énnemis chnagerons de tactique quand l'algérie l' algérie a éliminé les colonialisme francais tous les pays d'afrique d' afrique ont suiwi le modèle des Benmhidi et ses frères et soeures Matkhafouch Oqfo m3ana na3toulkoum la RECETTE	INTJ NOUN VERB VERB ADP DET PROPN VERB ADV DET NOUN ADJ CCONJ PRON VERB ADV DET NOUN VERB ADP NOUN SCONJ _ DET PROPN VERB VERB DET NOUN ADJ ADJ DET NOUN _ ADP PROPN VERB VERB DET NOUN ADP PROPN CCONJ DET NOUN CCONJ NOUN VERB VERB PRON VERB DET NOUN
vive les cip national et vive ziani belhaje; antare yahya wma w ma nansawche gazal li frahna wmazal w mazal yfarahna ktare m3a egthept nchalah	VERB DET NOUN ADJ CCONJ VERB PROPN PROPN PROPN PROPN _ CCONJ PART VERB PROPN PRON VERB _ CCONJ ADV VERB ADV ADP PROPN INTJ
fierre de vous welad beladdi hagdak farjouna fihomm bah ya3erfo me3amen rahoum yela3bou bon continuation	ADJ ADP PRON NOUN NOUN PRON VERB PRON ADP VERB PRON VERB VERB ADJ NOUN
bon jour nchalah rana f elmondial el mondial m3a yabda et megani et tout l'EN l' EN	INTJ X INTJ VERB ADP _ DET NOUN ADP PROPN CCONJ PROPN CCONJ ADJ _ DET NOUN
salam 3likoum khawti les algeriens nchallah ya rabi les verts yfarhouna f la l a frique du sud w nroho le 2ème tour brabi b rabi nchallah ad3ou m3ana ya r abi amine	INTJ PRON NOUN DET NOUN INTJ INTJ PROPN DET PROPN VERB ADP _ DET PROPN X PROPN PROPN CCONJ VERB DET ADJ NOUN _ ADP PROPN INTJ VERB PRON INTJ PROPN X INTJ
rabi m3ak bitawfik bi tawfik inchalah j c pas c jai j ai le froit de voter	PROPN PRON _ ADP NOUN INTJ PRON VERB ADV SCONJ _ PRON VERB DET NOUN ADP VERB
wallah wahed mahou intersted la bi karim wa la mourad wa l madjid dadou les jouer ta3a al chkara samir nasri mayoukhlesh kima ziani wallah ma yesthakou besh yellaabou fi les quipe national	INTJ NOUN PRON ADJ PART ADP PROPN CCONJ PART PROPN CCONJ PART PROPN PROPN DET NOUN ADP DET NOUN PROPN PROPN VERB SCONJ PROPN INTJ PART VERB ADP VERB ADP DET NOUN ADJ
w bssaha b ssaha 3a tous les algerien	CCONJ _ ADP NOUN ADP ADJ DET NOUN
za3ma raye7 ndir projet m3a l'anseg l 'anseg 3la les cams	INTJ VERB VERB NOUN ADP _ DET PROPN ADP DET NOUN
wayen had elghiba el ghiba ya 3ami 3athman ma khalawekch les généraux algérienne takhdam 3la rouhak ma3lich rabi wkilhoum	ADV PRON _ DET NOUN INTJ NOUN PROPN PART VERB DET NOUN ADJ VERB ADP NOUN INTJ PROPN NOUN
akdebou 3lina kebelema yefoutkoum l3am l 3am ces c es le revaion pas le poison daverile d averile alah yahedi ma khelak	VERB PRON ADP VERB _ DET NOUN _ PRON VERB DET NOUN ADV DET NOUN _ ADP NOUN PROPN VERB PRON VERB
haja wahda al mou3ak fil f il jazair mayakdarch yakhrouj la chare3 absat houkoukou fal f al hayat hram 3alikoum	NOUN ADJ DET ADJ _ ADP DET PROPN VERB VERB ADP NOUN ADJ NOUN _ ADP DET NOUN ADJ PRON
l'ess l' ess 3almo l'usma l' usma balon w keraohom werk w stilo	_ DET PROPN VERB _ DET PROPN NOUN CCONJ VERB NOUN CCONJ NOUN
ana fi l'age l' age nta3i 18 wa la premier foi ali ra7 n3awad al3am al 3am	PRON ADP _ DET NOUN PRON NUM CCONJ DET ADJ NOUN PRON VERB VERB _ DET NOUN
rayhin lele le le mondial ga3 m3a les verts w w koup d'afrique d' afrique m3a saaden jibou la victoire	VERB _ ADP DET NOUN ADV ADP DET PROPN CCONJ CCONJ NOUN _ ADP PROPN ADP PROPN VERB DET NOUN
anta tahlom b an tafouz 3ala maroc hhhhhhhhhhhhhhhh lmagharba l magharba homa flitoukese dialkom antoma les algeriene w hna khawa	PRON VERB ADP SCONJ VERB ADP PROPN INTJ _ DET NOUN PRON NOUN PRON PRON DET NOUN CCONJ PRON NOUN
m3ak yel khadra diri hala zkara fel f el khawana	PRON DET PROPN VERB NOUN ADV _ ADP DET NOUN
mazal 3aka mazal	ADV PRON ADV
rir sir le3ab fi franca hesan lik	PART VERB NOUN ADP PROPN ADJ PRON
boughera mlih 3ayan 3la la droite hato fel f el milieu ta3 la defence mé vive lalgerie l algerie et meghni	PROPN ADJ VERB ADP DET NOUN VERB _ ADP DET NOUN ADP DET NOUN CCONJ VERB _ DET PROPN CCONJ PROPN
normalement les filles doivent etre assez prudente parce que les algériens devient tous des malfaiteurs allah yastor et les filles devienne snobe o tama3at	ADV DET NOUN VERB VERB ADV ADJ SCONJ SCONJ DET NOUN VERB ADJ DET ADJ PROPN VERB CCONJ DET NOUN VERB ADJ CCONJ ADJ
ah lokan jat hadh leblad l eblad fi yadi wallah que n'ahihoum mel m el kharita ta3 el 3alem ( he c que wa3ra ) mai mlazem un jeste	INTJ SCONJ VERB PRON _ DET NOUN ADP NOUN INTJ SCONJ VERB _ ADP DET NOUN ADP DET NOUN PUNCT INTJ VERB SCONJ ADJ PUNCT CCONJ VERB DET NOUN
nous les supportteurs nous avec mouloudia ni avec 3amrousse ni zdak	PRON DET NOUN PRON ADP PROPN CCONJ ADP PROPN CCONJ PROPN
3ala barakat alah laou kountom sadikine	ADP NOUN PROPN SCONJ VERB ADJ
ou balak tkoluli jabet 12 par ce que nez3af	CCONJ INTJ VERB VERB NUM SCONJ X SCONJ VERB
pour le 08 té malade ya l3abassi	ADP DET NUM VERB ADJ INTJ PROPN
ana madabia yel3eb m3a les francé 3lakhaterch hada khsara ydji yel3eb m3a redjlin lem3iz le m3iz	PRON ADV VERB ADP DET NOUN SCONJ PRON NOUN VERB VERB ADP NOUN _ DET NOUN
3a9lia dima para jamais narja3 lawra la wra	NOUN ADV NOUN ADV VERB _ ADP NOUN
vive CRB nchalah hada l3ame l 3ame coupe w championi	VERB PROPN INTJ PRON _ DET NOUN NOUN CCONJ NOUN
bien nchallah brabi b rabi barabho alkoudivoire al koudivoire w anchallah yal3ab zyaya et kawawi allah la yrado howa ad3af a d3af wahad fi mca	ADV INTJ _ ADP PROPN VERB _ DET PROPN CCONJ INTJ VERB PROPN CCONJ PROPN PROPN PART VERB PRON _ DET ADJ NOUN ADP PROPN
je te dit ya mr bouriane willa rak téstéchfé fel f el mouslimine	PRON PRON VERB INTJ NOUN PROPN CCONJ VERB VERB _ ADP DET NOUN
allez les l Algérie la victoire est indispensable wa rana m3ak ya saadane	VERB DET DET PROPN DET NOUN VERB ADJ CCONJ VERB PRON INTJ PROPN
makan makan hada koulchi kdeb fe kdeb rahom 3aichine m3icha khasra dai3ou hyathouw fe batel mais la faute nta3 dawla nta3na	VERB VERB PRON PRON NOUN ADP NOUN VERB ADJ NOUN NOUN VERB NOUN ADP NOUN CCONJ DET NOUN ADP NOUN PRON
est oui rabi m3ak hadjar nchalah tu as fair une tré belle ie comme les autre filles nchalah	CCONJ INTJ PROPN PRON PROPN INTJ PRON VERB VERB DET ADV ADJ NOUN SCONJ DET ADJ NOUN INTJ
nchallah tach3al fihom ya rabi	INTJ VERB PRON INTJ PROPN
wah ghadi g3a nahargo krahna me had el blad la mizer noir	INTJ VERB ADV VERB VERB ADP ADP DET NOUN DET NOUN ADJ
allah akbar wa macha allah allah yeberek fik wa ana habba ara mawki3ouki eliliktrouni el iliktrouni wa assalmou a ssalmou 3alaykoum ya oukhty	PROPN ADJ CCONJ INTJ X PROPN VERB PRON CCONJ PRON VERB VERB NOUN _ DET ADJ CCONJ _ DET NOUN PRON INTJ NOUN
es salamo 3alayekom	DET INTJ PRON
ina li allah wa ina ilayhi raji3oun allah yarhemha bi rahmatihi al wassi3a	PRON ADP PROPN CCONJ VERB PRON ADJ PROPN VERB ADP NOUN DET ADJ
el bac rahe m3a l'encien l' encien systeme mais maintenant hab yradohme qui les chats makla et rkad	DET NOUN VERB ADP _ DET ADJ NOUN CCONJ ADV VERB VERB ADP DET NOUN NOUN CCONJ NOUN
ila kol wahed rah hassab el janah f la france rah ghalat as3ab chay fi donya el ghorbah	ADP DET NOUN VERB ADP DET NOUN ADP DET PROPN VERB ADJ ADJ NOUN ADP NOUN DET NOUN
Aek Mazal roh tel3ab les tournois dans ton cartié ta place n'est n' est pas dans l'équipe l' équipe national	INTJ ADV VERB VERB DET NOUN ADP DET NOUN DET NOUN _ ADV VERB ADV ADP _ DET NOUN ADJ
koun lajatni lmout l mout w 7akùmouni les batards , goulhom 3andi rsasa mkhabiha fi beyt nar	SCONJ VERB _ DET NOUN CCONJ VERB DET NOUN PUNCT VERB PRON NOUN ADJ ADP NOUN NOUN
yaaaaaa rabiiiiiii nchallah n3awdouhaaaaa et vive l'algerie l' algerie	INTJ PROPN INTJ VERB CCONJ VERB _ DET PROPN
hannachi dima msewwes m3a rouhou	PROPN ADV ADJ ADP NOUN
khlolna chber m3akom bach nogfo bark	VERB NOUN PRON ADP VERB ADV
jil machi mrabbi c'est c' est tout partout c fini le monde arabe 3arab jarab bye	NOUN PART ADJ _ PRON VERB PRON ADV VERB VERB DET NOUN ADJ NOUN NOUN INTJ
nasss tal3a l la lune we ntouma reyhou tedarbou 3la n'har el 3id ama houwa	NOUN ADJ ADP DET NOUN CCONJ PRON VERB VERB ADP NOUN DET NOUN CCONJ PRON
n'challah moi aussi l'annee l' annee prochain 19 émine ya rab al3alamine al 3alamine	INTJ PRON ADV _ DET NOUN ADJ NUM INTJ INTJ PROPN _ DET NOUN
rabi iwafakhoum nchalah wi koun m3ahoum idiro gloubham bark w yanssaw ga3 wach ga3ad issir elfoot el foot ta3 dzayer nchalh 02_ alg 00 lib	PROPN VERB INTJ CCONJ VERB PRON VERB NOUN ADV CCONJ VERB ADV PRON VERB VERB _ DET NOUN ADP PROPN INTJ NUM PROPN NUM PROPN
al hamdou lilah li lah 3ala tous est esperons que tous va bien inshaa alah	DET NOUN _ ADP PROPN ADP PRON CCONJ VERB SCONJ PRON VERB ADV INTJ X
c une blague depuis quand la france écoutes ce que va lui dire bouteflika rahima alaho man 3arifa 9adra nafssih	VERB DET NOUN ADV ADV DET PROPN VERB PRON SCONJ VERB PRON VERB PROPN VERB PROPN PRON VERB NOUN NOUN
3andek el hak hanachi surtou f les afriquant li nakssou alabalhoum rani f lybya	PRON DET NOUN PROPN ADV ADP DET NOUN PRON ADJ VERB VERB ADP PROPN
Lazmetni ghir secretaire ndir m3aha détournement	VERB PART NOUN VERB PRON NOUN
salam alikom wach darou joueurs locaux maranich hab nchouf hata local yel3ab 1 2 3 vive algerie	INTJ PRON PRON VERB NOUN ADJ VERB VERB VERB ADV ADJ VERB INTJ INTJ INTJ VERB PROPN
c la hontte domage 3adama alaho ajrakoum ina lilah li lah wa ina ilayhi raji3ine	VERB DET NOUN NOUN VERB PROPN NOUN VERB _ ADP PROPN CCONJ VERB PRON ADJ
je suis vraiment désolé ya 3aifaoui	PRON VERB ADV ADJ INTJ PROPN
Transfert direct mel m el compte hata lel l el compte	NOUN ADJ _ ADP DET NOUN ADP _ ADP DET NOUN
to rayan rabi isabrek wa thabtek 3ala achahada a chahada wa likoli ajalin kitab wa kolo nafsin daikato almawt al mawt wa ala3maro al a3maro beyadi b eyadi allah wa latansa ana allah howa achafi a chafi almo3afi al mo3afi nad3ou laka bechifaa b e chifaa inchaa allah la tansa ziyarat bayti allah lilhadj li l hadj aw 3omrah	ADP PROPN PROPN VERB CCONJ VERB ADP _ DET NOUN CCONJ ADP NOUN NOUN CCONJ DET NOUN ADJ _ DET NOUN CCONJ _ DET NOUN _ ADP NOUN PROPN CCONJ VERB SCONJ PROPN PRON _ DET ADJ _ DET ADJ VERB PRON _ ADP DET NOUN INTJ X PART VERB NOUN NOUN PROPN _ ADP DET NOUN CCONJ NOUN
Bchwia B chwia CH4 m3a el nitrates d’amonium d’ amonium	_ ADP ADV NOUN ADP DET NOUN _ ADP NOUN
w stif 3rosatna w hna m3aha w nchalah la coupe 3 tjr m3a chikh serrar	CCONJ PROPN NOUN CCONJ PRON PRON CCONJ INTJ DET NOUN NUM ADV ADP PROPN PROPN
èhhhhhhhhh ya nta heda mat3arfou wech a sahbi tu crois que ness boukoul kima tebka tkhaf tebka tjrs zawalii mais koun tnavigi w dir chuia mouvement ak toufraj 3lik rabi yfarajhaaaaaaa 3lihoumm nchallah	INTJ INTJ PRON PRON VERB ADV INTJ NOUN PRON VERB SCONJ NOUN VERB ADP VERB VERB VERB ADV ADJ SCONJ VERB VERB CCONJ VERB ADV NOUN PRON VERB PRON PROPN VERB PRON INTJ
Es salamou 3alaykoum	DET INTJ PRON
vive sa3dane dima ma3ak	VERB PROPN ADV PRON
o lokhera l okhera kan 3endha mard psychologique rebtoha b al 7abel zado darboha 3a rajlin	CCONJ _ DET NOUN VERB PRON NOUN ADJ VERB ADP DET NOUN VERB VERB ADP NOUN
hhhhh ntoma kolkom akhtaa wa narii fdii7a wach n9riwkom ana 3andi 16 ans kan3rf b ana l onta maymknch tkon mosaba b dak lmarad l marad mais katkon 7mila laho	INTJ PRON PRON NOUN CCONJ INTJ NOUN ADV VERB PRON PRON DET NOUN VERB ADP PRON DET NOUN VERB VERB ADJ ADP DET _ DET NOUN CCONJ VERB NOUN PRON
ya wallah maydirou lhom walou ya3tiwhou guarama maliya ou foute elhih loukane daratha edjazayare e djazayare m3a elmasriyin el masriyin kassamane billah bi llah guir yaharmouhom mane kasse el 3alam 2014 wa yzidou lhom guarama gade edounia e dounia elyahoud el yahoud w almasriyine al masriyine matfouthomche haddi 3lla eta3til e ta3til bayane erusulta e rusulta	INTJ INTJ VERB PRON PRON VERB NOUN ADJ CCONJ VERB ADV SCONJ VERB _ DET PROPN ADP _ DET NOUN ADV _ ADP PROPN PART VERB ADP NOUN DET NOUN NUM CCONJ VERB PRON NOUN NOUN _ DET NOUN _ DET NOUN CCONJ _ DET NOUN VERB PRON ADP _ DET NOUN ADJ _ DET NOUN
non morad svp ghir nta matel3abch fikatar fi katar khserna belhadje barakat svp	INTJ PROPN INTJ PART PRON VERB _ ADP PROPN VERB PROPN INTJ INTJ
inchalah tel3ab nta ya kho m3andiche confiance fi zamamouche	INTJ VERB PRON INTJ NOUN ADP NOUN ADP PROPN
3awda mowafaka ya matmour	NOUN ADJ INTJ PROPN
bon courage les champions vous etes toujours les meuilleurs vive l'entante l' entante de setif el3ali el 3ali	ADJ NOUN DET NOUN PRON VERB ADV DET ADJ VERB _ DET NOUN ADP PROPN _ DET ADJ
y3aggueb ayyèmet ramdan el bourek + chorba > ya3jbou el islam	VERB NOUN PROPN DET NOUN ADV NOUN PUNCT VERB DET NOUN
la preuve bel b el mo3awkin nta3 jsmb sna3 une tres bonne equipe	DET NOUN _ ADP DET ADJ ADP PROPN VERB DET ADV ADJ NOUN
mazalat alwizara al wizara toakid 3ala anaha ghabiya wala wa la tatasif bi ayi darat dakaaha ha ha nakol laha anti fachila walkarar w al karar dalil kati3 3ala dalik	ADV _ DET NOUN VERB ADP SCONJ ADJ _ CCONJ PART VERB ADP DET NOUN NOUN INTJ INTJ VERB PRON PRON ADJ _ CCONJ DET NOUN NOUN ADJ ADP PRON
Hamdoulah qu'on qu' on a encore MACHAYEKH en algérie Alahouma wafik wa alif kouloub ikhwanina 3arab et bani mezab à Benryane stp wach darou senegal m3a liberia ?? qui px me donné le résultat merçi d'avance d' avance	INTJ _ SCONJ PRON VERB ADV PROPN ADP PROPN PROPN VERB CCONJ VERB NOUN NOUN ADJ CCONJ NOUN PROPN ADP PROPN INTJ ADV VERB PROPN ADP PROPN PUNCT PRON VERB PRON VERB DET NOUN INTJ _ ADP NOUN
j adore annaba mais le mouloudia c tte ma vie j esper kan k an gagnera rabi m3ana nchalah al hakame almasri al masri 3amil israel 100 / 100 ( hasni la baraka allahou fika )	PRON VERB PROPN CCONJ DET PROPN VERB ADJ DET NOUN PRON VERB _ SCONJ PRON VERB PROPN PRON INTJ DET NOUN _ DET ADJ NOUN PROPN NUM PUNCT NUM PUNCT PROPN DET NOUN PROPN PRON PUNCT
123 viva l'algèrie l' algèrie m3a ya sa3dan	INTJ VERB _ DET PROPN ADP INTJ PROPN
wechkoun daha fikoum ! ahna ndirou 3achoura ta3na a l algerienne and we dont do nt care	ADV VERB PRON PUNCT PRON VERB PROPN PRON ADP DET PROPN CCONJ PRON _ VERB ADV VERB
ya djma3a khellou saadane yekhdem ila kan zeyaya fort i3ayatlou sur sinon allah ghaleb	INTJ NOUN VERB PROPN VERB SCONJ VERB PROPN ADJ VERB ADJ SCONJ PROPN ADJ
testehalou maketare rabi yesahel 3alikoum psk antouma les habitou hakeda	VERB ADV PROPN VERB PRON SCONJ PRON ADP VERB PRON
no wayyyyyyyyyyy m3a lyhoud l yhoud	ADV NOUN ADP _ DET NOUN
3am bali ki na7ki klemi iban ca va pas	ADP NOUN ADV VERB NOUN VERB DET VERB ADV
al jami3a almalakiya al malakiya al maghribia li korate al 9adam je dis bien al malakya khawf 3likm la bkito hak ghir m3a bnin	DET NOUN _ DET ADJ DET ADJ ADP NOUN DET NOUN PRON VERB ADV DET ADJ NOUN PRON PART VERB ADV PART ADP PROPN
bonne chance pour le rck vive les koubiéens inchallah tel3a é bonne chance pr alilou	ADJ NOUN ADP DET PROPN VERB DET NOUN INTJ NOUN CCONJ ADJ NOUN ADP PROPN
rabi m3ana matkhafouche pour mois chawchi ميسحقهاش بزاف قرعوها	PROPN PRON VERB ADP PRON PROPN VERB ADV VERB
sara bon bac et bon courage rabi yakhalik lwaldik l waldik w yehfdek men el3ain el 3ain	PROPN ADJ NOUN CCONJ ADJ NOUN PROPN VERB _ ADP NOUN CCONJ VERB ADP _ DET NOUN
allah el mosta3ane	PROPN DET ADJ
ana chefet lasseila la sseila b3ayeniya b 3ayeniya fihom les 2 rabi yekamel mais gaouaoui yestahel yel3eb m3a les grands li yel3bo f el champions ligue	PRON VERB _ DET NOUN _ ADP NOUN PRON DET PRON PROPN VERB CCONJ PROPN VERB VERB ADP DET ADJ PRON VERB ADP DET NOUN NOUN
domage pour ziaya normalment taw9afe m3a bladek	INTJ ADP PROPN ADV VERB ADP NOUN
Quelques grammes fe labo , le cadeau , nhoutou fel f el paquet	DET NOUN ADP NOUN PUNCT DET NOUN PUNCT VERB _ ADP DET NOUN
jamais y2ast jamais t3ast jamais 7best	ADV VERB ADV VERB ADV VERB
al 3ayn hak	DET NOUN NOUN
Lazmetlek des complices fe la poste w f la banque	VERB DET NOUN ADP DET NOUN CCONJ ADP DET NOUN
je suis choqué si vraiment grave allah yosstar ala bladna mina alirhab al irhab ila achi3a a chi3a	PRON VERB ADJ VERB ADV ADJ PROPN VERB ADP NOUN ADP _ DET NOUN ADP _ DET NOUN
ketro al mocha3widin li ze3ma yediro 9iyas char3iya	VERB DET NOUN PRON ADV VERB NOUN ADJ
rana me3akoum rabhin wela khasriiiiiiiiiiinnnnnnnnnnnnnnn dimaaaaaaaaaa	VERB PRON ADJ CCONJ ADJ ADV
vive ess contre el bordj sakk kr3ine lam3az l am3az	VERB PROPN ADP DET PROPN NOUN NOUN _ DET NOUN
mais les filles ta3na ysedkou n'import n' import quoi ana hada face book jamais cheftou khlah kalbi martahlouche malgré 3andi enternet depuis 4 ans dkhalet lesq sites kol ghire face book hada rabi yahdina	CCONJ DET NOUN PRON VERB _ ADV VERB PRON PRON PRON PROPN X ADV VERB ADV NOUN VERB ADP PRON NOUN ADV NUM NOUN VERB DET NOUN PRON PART PROPN X PRON PROPN VERB
tahya hara ila kol ansar al mouloudia ( chnaoua ) rana m3akom arabho babia bark 3la wajh chnaoua merci chorouk	NOUN ADJ ADP DET NOUN DET PROPN PUNCT ADJ PUNCT VERB PRON VERB PROPN ADV ADP NOUN PROPN INTJ PROPN
mon frere isam n 5 wach an9olak kho hadi lablade la blade ali aysamouha l'algeriè l' algeriè 9asmouha binathom choufe chab3a bante al anchore ya choro9e	PRON NOUN PROPN DET NUM ADV VERB NOUN PRON _ DET NOUN PRON VERB _ DET PROPN VERB PRON VERB NOUN PROPN DET VERB INTJ PROPN
1 - 2 - 3 je suis avec toi sa3dane wa zkara fi 3adiane viva l'algérie l' algérie	INTJ PUNCT INTJ PUNCT INTJ PRON VERB ADP PRON PROPN CCONJ ADV ADP NOUN VERB _ DET PROPN
Qbel maydour 3lik el3am el 3am tweli archi milliardaire	ADV VERB PRON _ DET NOUN VERB ADV NOUN
vive crb pour toujours la coupe inchallah had el 3am	VERB PROPN ADP ADV DET NOUN INTJ PRON DET NOUN
ça comence deja allah yaj3al l 5hir	PRON VERB ADV PROPN VERB DET NOUN
galbouni champalan , naktal bihom 99	VERB ADJ PUNCT VERB PRON PRON
cha3b flestin cha3b madlum hta wahad mabra y3awnah	NOUN PROPN NOUN ADJ ADV NOUN VERB VERB
c vrai que balon ydjib rabi les dirigeant du foot ma 3andna ma nkolo rahom khodra foug t3am	VERB ADV SCONJ NOUN VERB PROPN DET NOUN ADP NOUN PART PRON PART VERB VERB NOUN ADP NOUN
rabi yjiblak chfa ya chaouichi wnta w nta dayma four tog3ad four bazaffffffffffffffffffffffffffffffffffff	PROPN VERB NOUN INTJ PROPN _ CCONJ PRON ADV ADJ VERB ADJ ADV
Bravo 3alaik ya SORAYA HADDAD vive l'algerie l' algerie	INTJ PRON INTJ PROPN PROPN VERB _ DET PROPN
wayyyyyy rabhat ess vive ess tahat bikom ya jsk kontou l3am l 3am lli fat lawline l awline w dork thawssou tkounou lawline l awline hahaha	INTJ VERB PROPN VERB PROPN VERB PRON INTJ PROPN VERB _ DET NOUN PRON ADJ _ DET ADJ CCONJ ADV VERB VERB _ DET ADJ INTJ
wallahi ghire hab nsagel fiha mais 3andi bac en 2004 déplome de la sante de laboratoire	INTJ PART VERB VERB PRON CCONJ NOUN NOUN ADP NUM NOUN ADP DET NOUN ADP NOUN
rani m3a ta3li9 _ 26 _ wa elah yahdikom	VERB ADP NOUN PUNCT NUM PUNCT CCONJ PROPN VERB
vive toi mbolhi vraiment for bazef l confiance rah ytardag 3andek nchalah tfarhon m3a maricane	VERB PRON PROPN ADV ADJ ADV DET NOUN VERB VERB PRON INTJ VERB ADP PROPN
allez l usma brabi b rabi nerbhou et CRB kache 3ame	VERB DET PROPN _ ADP PROPN VERB CCONJ PROPN DET NOUN
vive usmh ou mabrok 3alikoum ya rck ou hapta likoum mabrok 3alikoum	VERB PROPN CCONJ INTJ PRON INTJ PROPN CCONJ NOUN PRON INTJ PRON
7awzoni wa ne plus 3awadt l'année l' année nta3 bac c tt	VERB CCONJ ADV ADV VERB _ DET NOUN ADP NOUN VERB PRON
rabi ama3ak o rbi ay3achk lina anchlah ya butaflika	PROPN PRON CCONJ PROPN VERB PRON INTJ INTJ PROPN
ya jma3a matlomohch hhhh yak l'algerie l' algerie fiha les option bazaf	INTJ NOUN VERB INTJ INTJ _ DET PROPN PRON DET NOUN ADV
on va gagné nchallah 3awadha ya saadane 123 vive lalgerie l algerie m3ak ya khadra diri hala	PRON VERB VERB INTJ VERB INTJ PROPN INTJ VERB _ DET PROPN PRON INTJ PROPN VERB NOUN
kont natmana yal3ab elhaj c'est c' est un grand joueur mi lazam nahtarmo l'intéligence l' intéligence de mr sa3dan	VERB VERB VERB PROPN _ PRON VERB DET ADJ NOUN CCONJ VERB VERB _ DET NOUN ADP NOUN PROPN
rabi yhafadna men l 3ayn chefti 3ayn l masriyin tokhroj mossiba	NOUN VERB ADP DET NOUN VERB NOUN DET NOUN VERB NOUN
ya alah insor falastin wa koun m3a i5wanina ana walah loukan ya5aliwni nroh walah mana83od wa vive l algirie	INTJ PROPN VERB PROPN CCONJ VERB ADP NOUN PRON INTJ SCONJ VERB VERB INTJ VERB CCONJ VERB DET PROPN
saber roba3i fanan mo7taram !!! i7na ma3ak ya saber laisse la caravane passe et les chiens aboient !!!	PROPN PROPN NOUN ADJ PUNCT PRON PRON INTJ PROPN VERB DET NOUN VERB CCONJ DET NOUN VERB PUNCT
il et miux ke mansouri et lamouchéya rah yjib waldah yal3ab	PRON VERB ADJ ADP PROPN CCONJ PROPN VERB VERB NOUN VERB
hadi hiya halet el harag maskinehata maskine hata bladhom matarhamhomche allah ykoun fi el 3awne wallah hada chi ybakini	PRON PRON NOUN DET NOUN _ ADJ ADV NOUN VERB PROPN VERB ADP DET NOUN INTJ PRON NOUN VERB
Bah nghati had koul nrouh nabnilhoum charikate	ADP VERB PRON ADJ VERB VERB NOUN
Nemsahoum el koul kih Hiroushima w Nakasaki	VERB DET NOUN SCONJ PROPN CCONJ PROPN
amala makache facilité had l 3ame	ADV VERB VERB PRON DET NOUN
vive l'algerie l' algerie zkara fel3adyene f el 3adyene	VERB _ DET PROPN ADV _ ADP DET NOUN
allahouma irhamhou w rham jami3a omatik ahyae wa amwat salam	PROPN VERB CCONJ VERB ADV NOUN ADJ CCONJ ADJ INTJ
elbariha el bariha dhabtou ila elmakan el makan el ladi kana fihi fariqe elwatani el watani wa kanete tadhar fi woudjouhihim el3azima el 3azima wa irada ka anahoum walahi osoude fi tarabosihim fi djanoub firaneca wakane wa kane hata 3awail tchadji3 farik el watani fi hadakel tarabous ma3a dalika el barde elqarisewa el qarise wa lame yametani3ou 3en elhodour el hodour li tachedji3e el khoder fa houm kanou fighaet fi ghaet el liyaqa wa iseti3edad	_ DET NOUN VERB ADP _ DET NOUN DET PRON VERB PRON NOUN _ DET ADJ CCONJ VERB VERB ADP NOUN _ DET NOUN CCONJ NOUN ADP PRON INTJ NOUN ADP NOUN ADP NOUN PROPN _ CCONJ VERB ADV NOUN ADJ NOUN DET ADJ ADP NOUN NOUN ADP PRON DET NOUN _ DET ADJ CCONJ PART VERB ADP _ DET NOUN ADP NOUN DET PROPN PART PRON VERB _ ADP NOUN DET NOUN CCONJ NOUN
ils ont fait ca contre les chi3a mais pour moi c une bonde de Vouyoux qui derije les saoudien c des traitre de lislam l islam	PRON VERB VERB PRON ADP DET NOUN CCONJ ADP PRON VERB DET NOUN ADP NOUN PRON VERB DET NOUN VERB DET ADJ ADP _ DET NOUN
nchalah yastawardo les jardiniés m3a lahchich la hchich bach yathanaw m hokan elras el ras	INTJ VERB DET NOUN ADP _ DET NOUN ADP VERB ADP NOUN _ DET NOUN
sa3youd sa3youde et 3aouadj et side 3li yahya chrife _bien sur djabou	PROPN PROPN CCONJ PROPN CCONJ PROPN PROPN PROPN PROPN ADV ADV PROPN
Ki nesma3 b'deux b' deux parties yeddabzou 3la lkoursi l koursi , j'men j' men m en fou ghir yakhtîwli rassi	ADV VERB _ ADP DET NOUN VERB ADP _ DET NOUN PUNCT _ PRON PRON PRON PRON VERB PART VERB NOUN
arréte de dire n'importe n' importe quoi lah yastrek on a aucun joueur yasthal yal3abe avec l'équipe l' équipe national wech njibo meftah ou bien ronaldinho ( hajd aissa khalina yarham babak beh vous avez di que ghir bougharra et matmour li yastahlo yala3bo alors je vous di y'a y' a un joueur mieu que yebda belhadj djebbour lahcen qui joue contre le barça et le real ect wali l3aklek rak hbalte ya sahbi si j'été j' été en place de chikh Saadane je ramène 23 joueur ga3 des prof w lfahem yafham	VERB ADP VERB _ ADV VERB PRON PROPN VERB PRON VERB DET NOUN VERB VERB ADP _ DET NOUN ADJ PRON VERB PROPN CCONJ ADV PROPN PUNCT PROPN PROPN VERB VERB NOUN INTJ PRON VERB VERB SCONJ PART PROPN CCONJ PROPN PRON VERB VERB ADV PRON PRON VERB _ PRON VERB DET NOUN ADJ SCONJ PROPN PROPN PROPN PROPN PRON VERB ADP DET PROPN CCONJ DET PROPN ADV VERB NOUN VERB VERB INTJ NOUN SCONJ _ PRON VERB ADP NOUN ADP PROPN PROPN PRON VERB NUM NOUN ADJ DET NOUN CCONJ VERB VERB
mala nzid n3awedha ngolha o ntebtha mada bik tektabha o fi galbek tro7 ta7fedha	ADV VERB VERB VERB CCONJ VERB ADV X VERB CCONJ ADP NOUN VERB VERB
rabi yostar mais nchalah y3awdou lkhasara l khasara nta3 lafric l afric w yraj3 lmoustawa l moustawa elmatloub el matloub	PROPN VERB CCONJ INTJ VERB _ DET NOUN ADP _ DET PROPN CCONJ VERB _ DET NOUN _ DET ADJ
slt rani m3a li9al li 9al mkan 7ta tafaw9 pq kamel sont des doublan mai 7abit ns9si li3andou li 3andou bac plus 1 es que 3andou droi ydir changment de filière	INTJ VERB ADP _ PRON VERB VERB ADV NOUN ADV PRON VERB DET NOUN CCONJ VERB VERB _ PRON PRON NOUN ADV NUM CCONJ SCONJ PRON NOUN VERB NOUN ADP NOUN
M3aak y al khadra quelque soit foot où hand !!!!!!!!	PRON INTJ DET PROPN SCONJ VERB NOUN CCONJ NOUN PUNCT
hamed li lahhe hadi 3ayenne bina ya la tife ya hafide	NOUN ADP PROPN ADJ VERB PRON INTJ ADJ X INTJ ADJ
djiche cha3b m3ak ya saadane	NOUN NOUN PRON INTJ PROPN
in shalah rabi m3ahom 9aulo amin	INTJ X PROPN PRON VERB INTJ
saha globna tabet men hada chai kol mara wahad hatan manalgaw hata wahad sagmou rawahkom wala khalona nado la3ib man elfirak el firak elmahliya el mahliya 3al akal mayfaysouch	INTJ NOUN VERB ADP PRON NOUN ADV NOUN NOUN ADV VERB ADV NOUN VERB NOUN CCONJ VERB VERB NOUN ADP _ DET NOUN _ DET ADJ ADP ADV VERB
c grave l'algerie l' algerie ga3 ma3andhach les stades	PRON ADJ _ DET PROPN ADV ADP DET NOUN
salam ecorouk el3abd el 3abd ida dja3 ewaly yasrak ida chba3 iwaly yafsak afham ya lfaham l faham	INTJ PROPN _ DET NOUN SCONJ VERB VERB VERB SCONJ VERB VERB VERB VERB INTJ _ DET NOUN
Za3ma ybi3a maykhafch , w houwa yékhdém m3a zefafa	ADV VERB VERB PUNCT CCONJ PRON VERB ADP NOUN
vive CRB o vive 3ani said baytari	VERB PROPN CCONJ VERB NOUN PROPN PROPN
a tous les repsonsables vous allez payer inchallah au lieu de consacrer l'arget l' arget de notre pays a construire des economies fortes et creer des emplois pour nos jeunes ils nous remenent de la racaille !!! allah yen3alkoum ya mesouline il youm eddine e ddine	ADP ADJ DET NOUN PRON VERB VERB INTJ ADP NOUN ADP VERB _ DET NOUN ADP DET NOUN ADP VERB DET NOUN ADJ CCONJ VERB DET NOUN ADP DET NOUN PRON PRON VERB ADP DET NOUN PUNCT PROPN VERB INTJ NOUN ADP NOUN _ DET NOUN
vive l'Algerie l' Algerie ou m3ak ya el khadra nchallah 4 - 0 ki ma gal khuoya	VERB _ DET PROPN CCONJ PRON INTJ DET PROPN INTJ NUM PUNCT NUM SCONJ X VERB NOUN
sanataghalab 3ala lmaghribe l maghribe manach mehtajine la ibrahimi la ben zima 3anedna la3ibine forts bla mziyet faranca	VERB ADP _ DET NOUN PART ADJ PART PROPN PART PROPN PROPN PRON NOUN ADJ ADP NOUN ADJ
kifech l'article l' article ygul un enfant a perdu sa main w enti tgouli 3ajbek al ihtifal !!!	ADV _ DET NOUN VERB DET NOUN AUX VERB DET NOUN CCONJ PRON VERB VERB DET NOUN PUNCT
am ydalou y madoulhom f le pris basah ki yla3bou m3ana	CCONJ VERB PRON VERB ADP DET NOUN CCONJ ADV VERB PRON
almouhim al mouhim masrkoulnache sina3at l3abirat l 3abirat lkarrat l karrat akmar sina3iya kamabil douriyya wa l3adala l 3adala wa lhouriyya l houriyya demokratiya fan taghiyir doustour	_ DET ADJ VERB NOUN _ DET ADJ _ DET ADJ NOUN ADJ NOUN ADJ CCONJ _ DET NOUN CCONJ _ DET NOUN NOUN NOUN NOUN NOUN
mazl 3aych belhadj	ADV ADJ PROPN
habt na3ref had la cocat li dafe3 3lih wach men wjeh 3andou ?!?!??!	VERB VERB PRON DET PROPN PRON VERB PRON DET ADP NOUN PRON PUNCT
vive csc dima inchalah tal3a lina vive csc	VERB PROPN ADV INTJ NOUN PRON VERB PROPN
wayn rah houari boumedien lou kan mazal kan rahou b3athhoum le saida ynehiw lhalfa fi sahara wa ychoufou hath les responsabble kif messaoulia	ADV VERB PROPN PROPN SCONJ VERB ADV VERB VERB VERB ADP PROPN VERB PROPN ADP PROPN CCONJ VERB ADV DET NOUN ADV NOUN
oui oui al3ab la cup d afrique bezzaf 3lik	INTJ INTJ VERB DET NOUN ADP PROPN ADV PRON
Lakane 3ajbetek el serqa bel b el crique , manloumekch khatak 3aqlietek tahbés fel f el houdoud ta3 qartik	SCONJ VERB DET NOUN _ ADP DET NOUN PUNCT VERB ADP NOUN VERB _ ADP DET NOUN ADP NOUN
chikh brahim koum tchouf ouache rahou yesstena fik ou weche rahou mkhabilek rabou el 3alamine ya chikhe jehenema	NOUN PROPN VERB VERB PRON VERB VERB PRON CCONJ PRON VERB VERB PROPN DET NOUN INTJ NOUN NOUN
ya chourouk khla3tini ki ktabti le titre ' katalou ' hssabt sah fiha ktila gouli khadi3a makida allah yahdina jami3an anchri ya	INTJ PROPN VERB ADV VERB DET NOUN PUNCT VERB PUNCT VERB ADJ PRON NOUN VERB NOUN NOUN PROPN VERB ADV VERB INTJ
vive chourouk vive l algerie ya rjal chourouk lazme tirou moustahil bache thalou chacha sur satelite et nous en è la vive chouroukkkkkkkkkkkkkkkkk rabi 3ayechekom	VERB PROPN VERB DET PROPN INTJ NOUN PROPN VERB VERB ADJ ADP VERB NOUN ADP NOUN CCONJ PRON PRON VERB ADV VERB PROPN PROPN VERB
l'ssentiel l' ssentiel madirouch fih lkdeb l kdeb kima ta3 l3arbi l 3arbi sinon tbehedlou bina	_ DET ADJ VERB PRON _ DET NOUN ADP ADP _ DET NOUN SCONJ VERB PRON
je suis pas accord ma3ak ya nadir rabi yahdik bahdlatna c pour sa hna b la3rab l a3rab 33adna lakheriin l akheriin	PRON VERB ADV NOUN PRON INTJ PROPN PROPN VERB VERB VERB ADP PRON PRON ADP _ DET NOUN VERB _ DET ADJ
tous les joueur cite fi larticle l article nont n ont pas le niveaux mondiale seul les journaux algerien houma li darlhom 3ima ga3 el 3am ou homa belhaj fe madrid yebda fe malaga mesbah fi napoli bougera fi arsenal boudebouz fi marseille ou taliatha chfou win rahom en breve les journauxi houma li daroulhom kima wa hna fi europa mayasma3 bihom hta wahed	ADJ DET NOUN VERB ADP _ DET NOUN _ ADV VERB ADV DET NOUN ADJ ADJ DET NOUN ADJ PRON PRON VERB NOUN ADJ DET NOUN CCONJ PRON PROPN ADP PROPN PROPN ADP PROPN PROPN ADP PROPN PROPN ADP PROPN PROPN ADP PROPN CCONJ NOUN VERB ADV VERB ADP NOUN DET NOUN PRON PRON VERB NOUN CCONJ ADV ADP PROPN VERB PRON ADV NOUN
c'est c' est un match de football nta tkoul chabah machabah football mat3tarafch bichabah bi chabah li3ahdou li 3ahdou f rijlih vas ganger	_ PRON VERB DET NOUN ADP NOUN PRON VERB NOUN ADJ NOUN VERB _ ADP NOUN _ ADP VERB ADP NOUN VERB VERB
t un vrais raciste ahchem ou nchalah rebi ya3akbek 3la el nifak ta33ek et laisser ce commentair svp	VERB DET ADJ ADJ VERB CCONJ INTJ PROPN VERB ADP DET NOUN PRON CCONJ VERB DET NOUN INTJ
Moutamaniyatona lakom bi Al Fawaz incha Allah tous les marocains Da3awatohom ma3akom ds ce mois de Ramadan al Karim ya Rab demain la victoire pour nos freres Algeriens de meme pour le Maroc contre le Togo meme si les chances pour se qualifier sont minimes de toute facon on sera tres contents au moins de voir l Algerie en coupe du monde	ADV PRON ADP DET NOUN INTJ X ADJ DET NOUN NOUN PRON ADP DET NOUN ADP PROPN DET PROPN INTJ NOUN ADV DET NOUN ADP DET NOUN NOUN ADP ADV ADP DET PROPN ADP DET PROPN ADV SCONJ DET NOUN ADP PRON VERB AUX ADJ ADP DET NOUN PRON AUX ADV ADJ ADP ADV ADP VERB DET PROPN ADP NOUN ADP NOUN
3aychine fiha ghir les miliardaire mai ga3 ji3anine algeria	ADJ PRON PART DET NOUN CCONJ ADV ADJ PROPN
nember 1 23456 ya3teekom saha ma3andy manzeed ingoul	NOUN NUM NUM VERB NOUN ADP VERB VERB
vive l'algerie l' algerie rana m3ak ya saadane w ya3tik essaha es saha ya zianni	VERB _ DET PROPN VERB PRON INTJ PROPN CCONJ VERB _ DET NOUN INTJ PROPN
3awadna el controle 3argadou aprés ma tatahraj nos l'algérie l' algérie beh éfikou	VERB DET NOUN VERB ADV PART VERB DET _ DET PROPN ADP VERB
dokan chahata laisa mamnou3an min al3ard al 3ard fi dowala l3arabiya l 3arabiya sahih darou 3lih daja kbir mais marahch manou3	NOUN PROPN VERB ADJ ADP _ DET NOUN ADP NOUN _ DET ADJ ADJ VERB PRON NOUN ADJ CCONJ VERB ADJ
ydiro el galb ghir m3a maser	VERB DET NOUN PART ADP PROPN
cette fois loukane tji marikane wellah ghir nrouh m3aha khir minkoum	DET NOUN SCONJ VERB NOUN INTJ PART VERB PRON ADJ PRON
Ma tchoufouch b3aynik b 3aynik bessah au fond tessouha bih	PART VERB _ ADP NOUN CCONJ ADP NOUN VERB PRON
W ngoul andi el haq , ani mharaq w galbi mwassékh	CCONJ VERB PRON DET NOUN PUNCT PRON ADJ CCONJ NOUN ADJ
les imigré 3andhoum draham	DET NOUN PRON NOUN
yakhi rkhass yakhi lah la terab7houm déja je connais les gens de Annaba ma3andehoumch ennif e nnif allah yahdihoum	INTJ ADJ INTJ PROPN PART VERB ADV PRON VERB DET NOUN ADP PART VERB _ DET NOUN PROPN VERB
nchalah kheir ya karim rabi eqoune m3akom	INTJ NOUN INTJ PROPN PROPN VERB PRON
Sah nensa les problemes el koul bel b el kemia	ADJ VERB DET NOUN DET PRON _ ADP DET NOUN
khawetena rahoum imoutou fi kamel aktar albouldan al bouldan al 3arabia we hebabna haslou fi sewaka ta3 mera	NOUN VERB VERB ADP ADV ADV _ DET NOUN DET ADJ CCONJ NOUN VERB ADP NOUN ADP NOUN
chi 3adi	NOUN ADJ
machi en 2005 rahoum ghir ykhaltou c en 2001 et wellah hada wlid 3ami ou na3arfou bien est en plus il a un diplôme d'informatique d' informatique si vous vouller savoir plus	PART ADP NUM VERB PART VERB VERB ADP NUM CCONJ INTJ PRON NOUN NOUN CCONJ VERB ADV CCONJ ADP ADV PRON VERB DET NOUN _ ADP NOUN SCONJ PRON VERB VERB ADV
vous avez raison rani me3akoum	PRON VERB NOUN VERB PRON
jib m3ak un kilo ta3 zlabiya et mrahba bik	VERB PRON DET NOUN ADP NOUN CCONJ INTJ PRON
rana fi la3wachir l a3wachir habbit ngoul belli Saadane der li 3lih Raho insene watani yhib la3lam l a3lam w rabbi nchallah ykoun fi 3awnou	VERB ADP _ DET NOUN VERB VERB SCONJ PROPN VERB PRON PRON VERB NOUN ADJ VERB _ DET NOUN CCONJ PROPN INTJ VERB ADP NOUN
ca je l`enttend l` enttend plusieur fois que des medecins disent au malade que tu vas mourir a une certaine date mais l`age l `age est a le dieu sebhanou inchallah tu vas guerrir et tu reprond votre espoir et inchallah inchallah inchallah tu vas guerrir ( amine ya rebbi l3alamine l 3alamine )	PRON PRON _ PRON VERB DET NOUN SCONJ DET NOUN VERB ADP ADJ SCONJ PRON VERB VERB ADP DET ADJ NOUN CCONJ _ DET NOUN VERB ADP DET PROPN NOUN INTJ PRON VERB VERB CCONJ PRON VERB DET NOUN CCONJ INTJ INTJ INTJ PRON VERB VERB PUNCT INTJ INTJ PROPN _ DET NOUN PUNCT
rabi ychafik w yaghfarlak donoubak w y3awadhalak hassanat fi mizanek 3alaika biassabr bi a ssabr wa kowat alimane al imane	PROPN VERB CCONJ VERB NOUN CCONJ VERB NOUN ADP NOUN PRON _ ADP DET NOUN CCONJ NOUN _ DET NOUN
w dork ani jit w3ad jil ani gajit	CCONJ ADV PRON VERB NOUN NOUN PRON NOUN
s'il s' il te plais chorouk ma tzidouch tenchrounna ta3ali9 ta3 lemrarka le mrarka lemcharkin le mcharkin a lemrarka le mrarka occupez vous de vos fesses et rohou ta3bdou el malik mouhamùadine essadisse es sadisse ra3ahou llahou wa 7afidahou wa adkhalahou lahou fas7a eljinani el jinani etc rahou ilah ta3kom	_ ADV PRON PRON VERB PROPN PART VERB VERB NOUN ADP _ DET NOUN _ DET ADJ INTJ _ DET NOUN VERB PRON ADP DET NOUN CCONJ VERB VERB DET NOUN PROPN _ DET ADJ VERB PROPN CCONJ VERB CCONJ VERB PRON ADJ _ DET NOUN ADV VERB PROPN PRON
Ki nesma3 bi les intéllo , kayen menhoum bel b el kilo , la brosse rej3at be'stylo be' stylo	ADV VERB ADP DET NOUN PUNCT VERB PRON _ ADP DET NOUN PUNCT DET NOUN VERB _ ADP NOUN
il faut ke te tconvoca w makan lah tjib l'avocat l' avocat	PRON VERB SCONJ PRON VERB CCONJ VERB NOUN VERB _ DET NOUN
vive nahd inchalah la coupe l e3am iljay il jay vive nahd contera 3ela crb est rck	VERB PROPN INTJ DET NOUN DET NOUN _ DET ADJ VERB PROPN ADP ADP PROPN CCONJ PROPN
inchallah alfawz al fawz algerie 2 / 0 vive alge tahyati ila cha3b algerie mgharbba m3akom dima khadra	INTJ _ DET NOUN PROPN NUM PUNCT NUM VERB PROPN INTJ ADP NOUN PROPN NOUN PRON ADV PROPN
courage les verts et rabi m3akoum on vous fait confiance et vive l'algérie l' algérie	NOUN DET PROPN CCONJ PROPN PRON PRON PRON VERB NOUN CCONJ VERB _ DET PROPN
aha waldi machi kima haka golna yakhi gotlak li yaghlat m3ak bdmagh b dmagh hada wach tfahmna ah tkhalasa ghalya nhar match zambia matkhafch	INTJ NOUN PART ADP PRON VERB INTJ VERB PRON VERB PRON _ ADP NOUN PRON PRON VERB INTJ VERB ADJ NOUN NOUN PROPN VERB
bon courage cheikh rana m3ak méme au pole nord rana jayine azdem lilamam li l amam marche ariere mharssa	ADJ NOUN PROPN VERB PRON ADV ADP NOUN ADJ VERB ADJ VERB _ ADP DET NOUN NOUN ADJ ADJ
slt l'algérie l' algérie jspr que ZIANI maydirahche bina kima LEMOUCHYA makalah tkoulou asbab 3ailia kima dertou m3a LEMOUCHYA wakil howa lihab li hab ykiti l'équipe l' équipe prcq mahouche mlih phisiquement il faut ziani ywali matensawche bli toute les but de l'algérie l' algérie jaw menou	INTJ _ DET PROPN VERB SCONJ PROPN VERB PRON ADP PROPN VERB VERB NOUN ADJ ADP VERB ADP PROPN NOUN PRON _ PRON VERB VERB _ DET NOUN SCONJ AUX ADJ ADV PRON VERB PROPN VERB VERB SCONJ ADJ DET NOUN ADP _ DET PROPN VERB PRON
Wach aamelna fi stiklal	PRON VERB ADP NOUN
hada nida3a ila raisse el tarrire	PRON NOUN ADP NOUN DET NOUN
makanche 3afsa tjik makanche formule magique	VERB NOUN VERB VERB NOUN ADJ
nchaa llah had l3am l 3am la cup f lhemri l hemri amin	VERB X PRON _ DET NOUN DET NOUN ADP _ DET PROPN INTJ
0 - 1 mabrouk 3alina hard luck pour el alahly	NUM PUNCT NUM INTJ PRON ADJ NOUN ADP DET PROPN
amr zaki l3ab 2mois 2 mois en première league rej3ouh baba rabbi malgre za3ema rahoume khere mena besahe me3ana yahebsou ou nedouheme allez retour	PROPN PROPN VERB _ NUM NOUN ADP ADJ NOUN VERB NOUN PROPN ADP ADV VERB ADJ PRON CCONJ PRON VERB CCONJ VERB VERB NOUN
yekhabrok les pompiers gedah men wa7ed lgaweh makheno9	VERB DET NOUN ADV ADP NOUN VERB ADJ
chaqu'un est libre li hab yroh roh wa li ma3ajbouche lhal l hal yak3OD fi daro matbahdolanache	PRON VERB ADJ PRON VERB VERB VERB CCONJ PRON VERB _ DET NOUN VERB ADP NOUN VERB
ya allah o3fou 3ana w arhamena berahmatik be rahmatik w la to3adibna w arhamen w ahfadna ya allah	INTJ PROPN VERB PRON CCONJ VERB _ ADP NOUN CCONJ PART VERB CCONJ VERB CCONJ VERB INTJ PROPN
1 2 3 vive l algerie pour tjr nchalah rabi ykoun m3ana	INTJ INTJ INTJ VERB DET PROPN ADP ADV INTJ PROPN VERB PRON
chaouchi c le n1 ou hwa li 3andou lhake l hake bach yal3abe titulaaire avec léquipe l équipe	PROPN VERB DET NOUN CCONJ PRON PRON PRON _ DET NOUN ADP VERB NOUN ADP _ DET NOUN
netmana tkon mobarat ikhwaniya w n3icho roh riyadiya 3alya w nchallah en a gagne le match bonne chanse	VERB VERB NOUN ADJ CCONJ VERB NOUN ADJ ADJ CCONJ INTJ PRON AUX VERB DET NOUN ADJ NOUN
30 sna men hyati 3adaw noires	NUM NOUN ADP NOUN VERB ADJ
123 vive algerie 456 milwoun fe la suisse 789 foi raih lel l el hdj hadi 3agllait mesoull fe blladie	INTJ VERB PROPN NUM NOUN ADP DET PROPN NUM NOUN VERB _ ADP DET NOUN PRON NOUN NOUN ADP NOUN
rabi yahdina jami3en wa allah yanssor al-hak al- hak wa al oullama wa dou3ates el mokhlissines	PROPN VERB ADV CCONJ PROPN VERB _ DET NOUN CCONJ DET PROPN CCONJ NOUN DET ADJ
wa3lah makach les argerien 3aichine fi mazabile elzair el zair é pourtant	ADV PART DET NOUN ADJ ADP NOUN _ DET PROPN CCONJ ADV
slt b1 sur belhadj le mailleur moi je dis saha aidkom wa kol 3am wa ntouma wa algerie bkhir b khir	INTJ ADV ADV PROPN DET ADJ PRON PRON VERB NOUN NOUN CCONJ DET NOUN CCONJ PRON CCONJ PROPN _ ADP NOUN
on va nshalah regler ce probleme de l'attaque l' attaque tgoul daroulna lagrigri la grigri ya ben 3ammi	PRON VERB INTJ VERB DET NOUN ADP _ DET NOUN VERB VERB _ DET NOUN INTJ NOUN NOUN
salam 3aleykoum	INTJ PRON
W ki nmout fe la fin nedi lakhra l akhra w denia	CCONJ ADV VERB ADP DET NOUN VERB _ DET NOUN CCONJ NOUN
Mouchkila m3akoum ya les jeunes Wallah même si je ne suis pas d'accord d' accord avec elle mais je vois que les algériens et la majorité des musulmans a perdu tout sens de l'islam l' islam Wellina nedawssou ghir fel les apparences elmadhahir el madhahir on est descendu trop trop bas hijab chwin gum barbes siwak 3oud elarak el arak et on a écarté l'essentiel l' essentiel Nous avons perdu notre logique nos cerveaux et les obscurantistes tels les karadawi et autre talibans ont remplacé nos cerveaux J'ai J' ai mal au coeur et vive elghorba el ghorba	NOUN PRON INTJ DET NOUN INTJ ADV SCONJ PRON ADV VERB ADV _ ADP NOUN ADP PRON CCONJ PRON VERB SCONJ DET NOUN CCONJ DET NOUN ADP ADJ AUX VERB DET NOUN ADP _ DET NOUN VERB VERB PART ADP DET NOUN _ DET NOUN PRON AUX VERB ADV ADV ADJ NOUN NOUN X NOUN NOUN NOUN _ DET NOUN CCONJ PRON AUX VERB _ DET NOUN PRON AUX VERB DET NOUN DET NOUN CCONJ DET NOUN ADJ DET PROPN CCONJ ADJ NOUN AUX VERB DET NOUN _ PRON VERB NOUN ADP NOUN CCONJ VERB _ DET NOUN
allahoma inessere ahelana fi palestine ina hada ade3afe a de3afe ale imane ina el jazayare balade el chouhadae wa alaherare al aherare nanetadire mine cha3ebiha aketare mine hadakoulena ma3a palestine el habiba	PROPN VERB NOUN ADP PROPN SCONJ PRON _ DET NOUN ADP NOUN SCONJ DET PROPN NOUN DET NOUN CCONJ _ DET ADJ VERB ADP NOUN ADV ADP PRON ADP PROPN DET ADJ
kan nmout had stylo fih risque	VERB VERB PRON NOUN PRON NOUN
rabi yestour le petrole rayeh ykhlasse 3al 16 sena	PROPN VERB DET NOUN ADJ VERB ADP DET NOUN
salame olla-i el khawanna el mounafikine youfakiroune fi ba3te 3000 djoundi illa el sudan mine adjle moubarate kourate el kadame oua el yahoude yadbahouna fi ikhwanahoume el falastiniyine oua la you fakiroune hatta bi i3anatihime hatta bi el khoubze bale youhasirounahoume bi djidare fouladdi hasbouna allahou wa ni3ma el wakile 3alihoume oua 3alla koule mane ata3ahoume ( bismi b ismi allahi el rahmane el rahime inna fir3awna istakhafa kawmahou fa ata3ouhe )	INTJ INTJ DET NOUN DET ADJ VERB ADP VERB NUM NOUN ADP DET PROPN ADP NOUN NOUN NOUN DET NOUN CCONJ DET NOUN VERB ADP NOUN DET NOUN CCONJ PART VERB X ADV ADP NOUN ADV ADP DET NOUN CCONJ VERB ADP NOUN ADJ VERB PROPN CCONJ ADJ DET NOUN PRON CCONJ ADP PRON PRON VERB PUNCT _ ADP NOUN PROPN DET ADJ DET ADJ SCONJ PROPN VERB NOUN CCONJ VERB PUNCT
3andak el ha9 ya ( 42 ) hada klam wala khalina	PRON DET NOUN INTJ PUNCT NUM PUNCT PRON NOUN CCONJ VERB
Allah khalaka daa et ma3ahou Dawaa	PROPN VERB NOUN CCONJ PRON NOUN
salam 10 % des algeriens payent les impots les autres kayenne m3arifa	INTJ NUM NOUN DET NOUN VERB DET NOUN DET NOUN VERB NOUN
barak allah fik wallah haja mliha blad rajala ya3arfou la valeur de rajala made en algerie	VERB PROPN PRON INTJ NOUN ADJ NOUN NOUN VERB DET NOUN ADP NOUN ADJ ADP PROPN
ils ont raison mais hna aussi 3andena des examens le 7 janvier il nous reste 12 cours on fait comment	PRON VERB NOUN CCONJ PRON ADV PRON DET NOUN DET NUM NOUN PRON PRON VERB NUM NOUN PRON VERB ADV
rabi y3awnkom mes freres w ga3 rana m3akom	PROPN VERB DET NOUN CCONJ ADV VERB PRON
le jour ou en a jouer a om dorman kona 3arfin bli nrbho li ana shaha tatata2aba avant que le match commance w tata2ob mina chaytan golo l sa3dan ki dir kaskita nakhasro	DET NOUN ADV PRON AUX VERB ADP PROPN PROPN AUX ADJ SCONJ VERB SCONJ X PROPN VERB ADP SCONJ DET NOUN VERB CCONJ NOUN ADP NOUN VERB ADP PROPN ADV VERB NOUN VERB
dzl suis etudient w ani na3ref ache hiya al jami3a seraha matferahch	ADJ VERB NOUN CCONJ PRON VERB PRON PRON DET NOUN ADV VERB
sob7an alah la societe rabet en force les problemes ta3 les familles o machakil ta3 divorce	NOUN PROPN DET NOUN VERB ADP NOUN DET NOUN ADP DET NOUN CCONJ NOUN ADP NOUN
mabrouk 3alik si saibi et bonne reussite inchallah	INTJ PRON NOUN PROPN CCONJ ADJ NOUN INTJ
allah yansor alhag al hag /w zid rahom yastahlou saf3a mna la fifa	PROPN VERB _ DET NOUN CCONJ VERB VERB VERB NOUN VERB DET PROPN
3andi dakhira ta3 la fam w ci minon	PRON NOUN ADP DET NOUN CCONJ VERB ADJ
3lah diro fi fetna w li ydrha rabi yahrgo w rana m3ak ya saadan w 3am ya les verts	ADV VERB ADP NOUN CCONJ PRON VERB PROPN VERB CCONJ VERB PRON INTJ PROPN CCONJ NOUN INTJ DET PROPN
au fi bladha ou matidihach bel b el 3a9liya adi	CCONJ ADP NOUN CCONJ VERB _ ADP DET NOUN PRON
ahna diwana fi illizi 3endna 5 snine nbet fina ermel e rmel wahed ma kdar imitina ja bouderbala hna w galna fi 3achhor 3 achhor enmitikom mi domage R A S	PRON NOUN ADP PROPN PRON DET NOUN VERB PRON _ DET NOUN NOUN PART VERB VERB VERB PROPN ADV CCONJ VERB ADP _ DET NOUN VERB CCONJ INTJ ADV ADP VERB
Il y’on y’ on a peut être qui dit	PRON _ PRON PRON VERB ADV X PRON VERB
winraho film el sifara fil3imara fi l 3imara hada ga3 tenhal khadmou m3a lihoud l ihoud wa man kal hmas dalima fa howa min al charoun	VERB NOUN DET NOUN _ ADP DET NOUN PRON ADV VERB VERB ADP _ DET NOUN CCONJ ADP DET PROPN ADJ PART PRON ADP DET PROPN
ziani howa lihab li hab labagar la bagar lazem idir rejlih fi lema le ma bared malgri yal3ab melih besah il faux controli roho bach mayadich carton g wela rouge	PROPN PRON _ PRON VERB _ DET NOUN VERB VERB NOUN ADP _ DET NOUN ADJ ADP VERB ADV CCONJ PRON VERB VERB NOUN ADP VERB NOUN ADJ CCONJ ADJ
7ena Rana mane tawat berriane rabi ya7efdak wi 3awenak zekara feli maye7abenach	PRON VERB ADP PROPN PROPN PROPN VERB CCONJ VERB ADV ADP VERB
Mon cher frére Rayan inchallah que dieu te guérise soubhanahoo allahooma echfika w echfi mardha moosslimine allahooma ab3id 3anka el alama w assakama a ssakama allahooma inaka kadir wa bilijabatti bi l ijabatti jadir mes chers lecteurs dou3aa a notre cher frére Rayan et aux musilmans amine ya rabbi	DET ADJ NOUN PROPN INTJ SCONJ PROPN PRON VERB NOUN PROPN VERB CCONJ VERB NOUN NOUN PROPN VERB PRON DET NOUN CCONJ _ DET NOUN PROPN SCONJ ADJ CCONJ _ ADP DET NOUN ADJ DET ADJ NOUN NOUN ADP DET ADJ NOUN PROPN CCONJ ADP NOUN INTJ INTJ PROPN
el ostad lasa 3ado likin oh ka elab el ab etani e tani li atilmid a tilmid	DET NOUN PART NOUN CCONJ PRON ADP _ DET NOUN _ DET ADJ ADP _ DET NOUN
éstaghfire élah ya l3anabi l 3anabi	VERB PROPN INTJ _ DET PROPN
hada blastah machi madrasa hadi hata fe tanawiya hata krahna kol wahd yegoul 3askar wela harse 3ame met wache bari dire sebor	PRON NOUN PART NOUN PRON ADP ADP NOUN ADP VERB DET NOUN VERB NOUN CCONJ NOUN ADJ VERB ADV VERB VERB NOUN
Bach nebranché mon argent lazmetli 3afsa ndifa khfifa	ADP VERB DET NOUN VERB NOUN ADJ ADJ
w 3andah assah as sah	CCONJ PRON _ DET NOUN
fakou yjubou des projet yekhdmouhom m3a shabhoum yfasslou w yelbssou yakhi blad yakhi	VERB VERB DET NOUN VERB ADP NOUN VERB CCONJ VERB INTJ NOUN INTJ
khoya rayane Rabi yachfik chada fel f el lah inchalah rabi ya3tik sabr saydna AYOUB ya rab el 3alamine et bachfa b a chfa 3lik khoya	NOUN PROPN PROPN VERB ADJ _ ADP DET PROPN INTJ PROPN VERB NOUN NOUN PROPN INTJ PROPN DET NOUN CCONJ _ ADP DET NOUN PRON NOUN
wellina nkhafou ndirou Opération hata fi bladna wallah la 3ayb wine biha ya blaaad !!	VERB VERB VERB NOUN ADP ADP NOUN INTJ PART NOUN ADV PRON INTJ NOUN PUNCT
ellah la eyrbahhom 3lach ma yrohoch eyjahdo fi falastin wla eljihad el jihad m3a khwthom khwarj rabi eysfihom enchalah	PROPN PART VERB ADV PART VERB VERB ADP PROPN CCONJ _ DET NOUN ADP NOUN NOUN PROPN VERB INTJ
Mateqderch 3lihoum khatak mokhek mechou guedhoum	VERB PRON ADP NOUN PRON NOUN
Kount qader nhij w nhéz	VERB ADJ VERB CCONJ VERB
3adhama ALLAHO AJRAKOM	VERB PROPN NOUN
al3ayadi wa mane houm 3ala chakilatihi hom el mourdjifounes tadjidouhoum fi koulli zamane	PROPN CCONJ PRON PRON ADP NOUN PRON DET ADJ VERB ADP DET NOUN
balek rahom meghaltinek ya jaloul beli anachid helal ya y a ghir kifkif hia we ray ahssenelek ba3d 3la ghinaa en general la habit toob tawba nassoha 3andek essah e ssah khoya foad canstantine	INTJ VERB VERB INTJ PROPN SCONJ NOUN ADJ _ PRON VERB PART ADV PRON CCONJ NOUN ADJ VERB ADP NOUN ADP ADV SCONJ VERB VERB NOUN ADJ PRON _ DET NOUN NOUN PROPN PROPN
howa w chiwya may9rache 7eta al 3arbiya	PRON CCONJ ADV VERB ADP DET NOUN
yawe daze me3ahome 3akdine 3likome 3akdine habasse championnat mathabache dire wach tehabe el fayda lina nechab3oukoume foule inchalah	INTJ NOUN PRON ADV PRON ADV VERB NOUN VERB VERB PRON VERB DET NOUN PRON VERB NOUN INTJ
ina lilahi li lahi wa inna ilayhi radji3oune la hawla wala wa la kowata illa billah bi llah innahom dou3at 3ala aboibe djahanem	VERB _ ADP PROPN CCONJ VERB PRON ADJ PART NOUN _ CCONJ PART NOUN PART _ ADP PROPN SCONJ NOUN ADP NOUN NOUN
yah rabi l3abd l 3abd adak aw ma yastahelche ykon jazayri kon ghir ma rj3che l bladna puisque lblad l blad hadi ma testahelche wahed kifooo	INTJ PROPN _ DET NOUN PRON CCONJ PART VERB VERB NOUN VERB PART PART VERB ADP NOUN SCONJ _ DET NOUN PRON PART VERB NOUN PRON
salam 3alikoum avez vous déja vues un homme politique ou un membre de l'etat l' etat ou un organisme de l'etat l' etat son represantant est jeune ? la photo de ech-chourouk prouve que nos décideurs sont vieux ils ont un pied dans la tombe asteghfir Allah et ils tiennes tjrs au pouvoir yaw el moute kayna	INTJ PRON VERB PRON ADV VERB DET NOUN ADJ CCONJ DET NOUN ADP _ DET NOUN CCONJ DET NOUN ADP _ DET NOUN DET NOUN VERB ADJ PUNCT ADP NOUN ADP PROPN VERB SCONJ DET NOUN VERB ADJ PRON VERB DET NOUN ADP DET NOUN VERB PROPN CCONJ PRON VERB ADV ADP NOUN INTJ DET NOUN VERB
La premiere etape c’est c’ est l’ecole l’ ecole fondamentale	DET ADJ NOUN _ PRON VERB _ DET NOUN ADJ
ya rebi narabho m3a zambia we m3a rwanda we nrouho l masser b les jeune	INTJ PROPN VERB ADP PROPN CCONJ ADP PROPN CCONJ VERB ADP PROPN ADP DET ADJ
73 firga kollohom fi nar illa wahida Wa kollohom yagoloun la Illah illa ALLAH Mohammed Rassoul ALLAH wa yossaloun wali dalik khod hidrak akhi okhti ilzam ahl sunna wa ljama3a l jama3a wa salaf	NUM NOUN PRON ADP NOUN PART ADJ CCONJ PRON VERB PART PROPN PART PROPN PROPN NOUN PROPN CCONJ VERB ADV PRON VERB NOUN NOUN NOUN VERB NOUN NOUN CCONJ _ DET NOUN CCONJ NOUN
rabi ma3ak cheikh on vous respecte nhabouk ouallah bonne chance le 07/ juin	PROPN PRON NOUN PRON PRON VERB VERB INTJ ADJ NOUN DET NUM NOUN
dir fi rohek grand plaisir w ista9il yrehem waldik rak karehtena f l 9raia khatrach wladek khalso 9raitehom 3liha bdit tekhalet 3lina w syaset - copier coller - mn 3and l europe	VERB ADP NOUN ADJ NOUN CCONJ VERB VERB NOUN VERB VERB ADP DET NOUN SCONJ NOUN VERB NOUN PRON VERB VERB PRON CCONJ NOUN PUNCT VERB VERB PUNCT ADP ADP DET PROPN
moi avec khalilozitch 3adna un bonne equipe et viva lagerie l agerie	PRON ADP PROPN PRON DET ADJ NOUN CCONJ VERB _ DET PROPN
w hna m3ak ya sa3dan mais lazm tnahi mansouri w hadak gazzel	CCONJ PRON PRON INTJ PROPN CCONJ VERB VERB PROPN CCONJ PRON NOUN
wach men mostakbel pour EN avec ces c es ;essentiel jazeer raht m3a boumedien < 3assad < majer e beloumi le reste c rien que ;;;;;;;;;;;;;;;; hachakom	DET ADP NOUN ADP NOUN ADP _ PRON VERB ADJ PROPN VERB ADP PROPN PUNCT PROPN PUNCT PROPN CCONJ PROPN DET NOUN VERB PRON SCONJ PUNCT VERB
moi mon intervention se resume sur ça bon courage a notre equipe allah m3ana	PRON DET NOUN PRON VERB ADP PRON ADJ NOUN ADP DET NOUN PROPN PRON
vive la algeres zkarra fal3adian f al 3adian	VERB DET PROPN ADV _ ADP DET NOUN
Anaya l youm jm'en j m' en fou , ki 3retf lyoum l youm koulchi festi	PRON DET NOUN _ PRON PRON PRON VERB PUNCT ADV VERB _ DET NOUN PRON ADJ
inchalah bark yfarhouna ya rabrabi m3a houmet bon courage notre équipe nationale rana m3akoum malgré tous	INTJ ADV VERB INTJ PROPN ADP NOUN ADJ NOUN DET NOUN ADJ VERB PRON ADP PRON
bah fransa jiha sahla w 3lach madarouhache m3a la core wla m3A L'ALMMAGNE L' ALMMAGNE	INTJ PROPN VERB ADJ CCONJ ADV VERB ADP DET NOUN CCONJ ADP _ DET PROPN
setif reste setif malgrie tout besah ntouma wach dertou t3arfou gir tahadrou	PROPN VERB PROPN ADV PRON CCONJ PRON PRON VERB VERB PART VERB
lyoum l youm na7ki le7kayat le 7kayat li rahom f setra kima les bebes li legawhom taychin f zebla	_ DET NOUN VERB _ DET NOUN PRON VERB ADP NOUN SCONJ DET NOUN PRON VERB ADJ ADP NOUN
ma chaa allah wa la kowata illa billeh bi lleh vrémnt il nous a honoré à léétranger l éétranger je lui souhouhaite 1e bonne continuation pleine de succé et de fiérté bravo ould bledi rabi m3ak	PRON VERB PROPN CCONJ PART NOUN PART _ ADP PROPN ADV PRON PRON VERB VERB ADP _ DET NOUN PRON PRON VERB DET ADJ NOUN ADJ ADP NOUN CCONJ ADP NOUN INTJ NOUN NOUN PROPN PRON
ila 3ali limada la taghlik famaka ya mon frere ana kadalik min ouedrhiou	ADP PROPN ADV PART VERB NOUN INTJ DET NOUN PRON ADV ADP PROPN
yla 3andna da3wa 3ande raber inchalah yakhasro bi 4 a 0 amine ya rabi za3ma mca hhhh al3amide al 3amide hhhhh frik l3acima l 3acima hhhh	SCONJ NOUN NOUN ADP PROPN INTJ VERB ADP NUM ADP NUM INTJ INTJ PROPN ADV PROPN INTJ _ DET NOUN INTJ NOUN _ DET NOUN INTJ
rana dima nestanao fi wladna rbi yechfihom w m3ak ya elkhadra el khadra	VERB ADV VERB ADP NOUN PROPN VERB CCONJ PRON INTJ _ DET PROPN
maskina rabi ykoin m3aha koun ma jach yadrabha mathawalche takatlo kima ana	ADJ PROPN VERB PRON VERB PART VERB VERB VERB VERB ADP PRON
il faut gagner le match et vous présentons l'algerie l' algerie on nchalah matadarbouche 3la alminha al minha kima 3am li féte	PRON VERB VERB DET NOUN CCONJ PRON VERB _ DET PROPN CCONJ INTJ VERB ADP _ DET NOUN ADP NOUN PRON ADJ
C’est C’ est bon nchikh w n3ich dima farhane	_ PRON VERB ADV VERB CCONJ VERB ADV ADJ
hasebouna alah wa naima el wakil alahouma la touakhidna bima fa3ala esoufahaou mina	NOUN PROPN CCONJ NOUN DET ADJ PROPN PART VERB PRON VERB ADJ PRON
123 vive chabiba rana m3akom farhouna rana za3fanine	INTJ VERB PROPN VERB PRON VERB VERB ADJ
1 2 3 viva l'algerie l' algerie roh ya 3ammou sa3dane rak rabeh	INTJ INTJ INTJ VERB _ DET PROPN VERB INTJ NOUN PROPN VERB ADJ
Soufiya mad3ouma bi amrika wa wazir choun dinaya wa mr Wa hadafohom tadlil lmoslimin l moslimin 3an dinihim wa nachr lkhorafat l khorafat wa lbida3 l bida3 wa binaa fi kol madina zawya wa darih wa hom ktiroun fi gharb ljazayar l jazayar wa in kanat lahom 3assima fa hiya Mostaghanem Hadari hadari ya ikhwan wallahi innahom achado khataran min bani sohyoun wa nassara	NOUN ADJ ADP PROPN CCONJ NOUN NOUN ADJ CCONJ VERB CCONJ NOUN NOUN _ DET NOUN ADP NOUN CCONJ NOUN _ DET NOUN CCONJ _ DET NOUN CCONJ NOUN ADP DET NOUN NOUN CCONJ NOUN CCONJ PRON ADJ ADP PROPN _ DET PROPN CCONJ SCONJ VERB PRON NOUN PART PRON PROPN INTJ INTJ INTJ NOUN INTJ SCONJ ADV ADJ ADP NOUN NOUN CCONJ NOUN
ncahalah ykoun khalifa ta3 zizou li farah la france w nchalah madine yal3ab pour l'algerie l' algerie et toujours vive l'algerie l' algerie	INTJ VERB NOUN ADP PROPN PRON VERB DET PROPN CCONJ INTJ PROPN VERB ADP _ DET PROPN CCONJ ADV VERB _ DET PROPN
we 7na ki nchofoha ngolo cho yekhi khamja	CCONJ PRON ADV VERB VERB VERB INTJ ADJ
ana maghrabi rana 3aychine fel f el miziriya walla yan3al malik diyalna li klanaw tahiya polizariyo w tahiya l hak	PRON NOUN VERB ADJ _ ADP DET NOUN CCONJ VERB NOUN PRON PRON VERB VERB NOUN CCONJ VERB DET NOUN
vive csc dima 3aam eltal3a el tal3a	VERB PROPN ADV NOUN _ DET NOUN
Nachri tayarate w des banques kima el khalifa	VERB NOUN CCONJ DET NOUN SCONJ DET NOUN
3andek essah e ssah ya mol ta3lik 2 yebda wa 00 kifkif	PRON _ DET NOUN INTJ NOUN NOUN NUM VERB CCONJ NUM ADV
mdrrrrrr ^_^ ani 1er année f' fac mais jamais chofttt tchomirrrr kima la fac ^_^ w machofna walouuuu m3a LMD ; sarah ta t a raissson et toii imen a la brochaine nchlh ;; yagdab 3lihkomm lé golkom kayena 9raya fel'algerie fe l' algerie ^^ mon faceboook ; LaSs ilyes	INTJ INTJ VERB DET NOUN ADP NOUN CCONJ ADV VERB NOUN ADP DET NOUN INTJ CCONJ VERB PRON ADP PROPN PUNCT PROPN _ PRON VERB NOUN CCONJ PRON PROPN ADP DET ADJ INTJ PUNCT VERB PRON PRON VERB VERB NOUN _ ADP DET PROPN INTJ DET PROPN PUNCT PROPN PROPN
rana chafna elhaj ds le match algerie + brizil malgri l3ab 10 min mi il fait la déferance	VERB VERB PROPN ADP DET NOUN PROPN PUNCT PROPN ADP VERB NUM NOUN CCONJ PRON VERB DET NOUN
je veux te dire que c'est c' est le Dieu qui sait notre delai et notre dernier moment dans cette vie et pas les professeurs mais hamdo laah tu es un mesulman garde espoir à Dieu et soi sur que tous les gens qui t'aime t' aime vont pas cesser de prier pour toi et incha allah inchallah inchallah tu vas guerrir et tu vas remedier rappi ychafik w y3afik w ychafi marda l moslimin ajma3in ya rappun grand salut du Maroc avec des souhaits de querrison pour toi rayan	PRON VERB PRON VERB SCONJ _ PRON VERB DET PROPN PRON VERB DET NOUN CCONJ DET ADJ NOUN ADP DET NOUN CCONJ ADV DET NOUN CCONJ NOUN PROPN PRON VERB DET NOUN VERB NOUN ADP PROPN CCONJ VERB ADJ SCONJ ADJ DET NOUN PRON _ PRON VERB VERB ADV VERB ADP VERB ADP PRON CCONJ INTJ X INTJ INTJ PRON VERB VERB CCONJ PRON VERB VERB PROPN VERB CCONJ VERB CCONJ VERB NOUN DET NOUN ADV INTJ NOUN ADJ NOUN ADP PROPN ADP DET NOUN ADP NOUN ADP PRON PROPN
entoum ya thouar la tastahou ma3andoukoum la dine oua la mela	PRON INTJ ADJ PART VERB ADP PART NOUN CCONJ PART NOUN
Bon courage les aigles Rabbi m3akom wled l'entente l 'entente	ADJ NOUN DET PROPN PROPN PRON NOUN _ DET PROPN
rebi m3a les forces de sécuritée	PROPN ADP DET NOUN ADP NOUN
n3albouhom drahem elmohim el mohim la qualification	VERB NOUN _ DET ADJ DET NOUN
kata3touna kalbna ma3liche hbibi yjibe rabi sa3ate el kheire nchalah allah yarzake ch'fa y'en y' en n'a mare a bat le terorisme malina hade el chi hada 3la bali klile ga3e weche kolte marahche yraja3 lak rajlike maktoube rabi chade fihe hadamak rabi ykone m3ak	VERB NOUN INTJ NOUN VERB PROPN NOUN DET NOUN INTJ PROPN VERB NOUN _ PRON PRON VERB ADV ADP ADV DET NOUN VERB PRON DET NOUN PRON ADP NOUN ADV ADV ADV VERB VERB VERB PRON NOUN ADJ PROPN VERB PRON PRON PROPN VERB PRON
saifi khirlak khir lak troh adir jubilée fi asr3a wakt momkin intahat salahiyatek by merci	PROPN _ ADJ PRON VERB VERB NOUN ADP ADJ NOUN ADJ VERB NOUN INTJ INTJ
salam wallah je ne comprends rien ; un pays comme la lybie les algeriens se trouvent écroué dans l'injustice l' injustice et le mal c'est c' est malheureux ; je lance un appel a tous les algeriens que notre pays est mieux que la lybie wallah el 3adim ; la lybie est un pays classé anarchique ni droit de l'homme l' homme ni ni sauf repression contre les ALGERIENS ils sont champion je prefere ragarder tom et jerry mieux de me balader dans un pays d'injustice d' injustice	INTJ INTJ PRON ADV VERB PRON PUNCT DET NOUN ADP DET PROPN DET NOUN PRON VERB VERB ADP _ DET NOUN CCONJ DET NOUN _ PRON VERB ADJ PUNCT PRON VERB DET NOUN ADP ADJ DET NOUN SCONJ DET NOUN VERB ADJ SCONJ DET PROPN INTJ DET ADJ PUNCT DET PROPN VERB DET NOUN VERB ADJ ADV NOUN ADP _ DET NOUN ADV ADV ADP NOUN ADP DET NOUN PRON VERB NOUN PRON VERB VERB PROPN CCONJ PROPN ADJ ADP PRON VERB ADP DET NOUN _ ADP NOUN
w i gol lik yajoz 3andi 2a7adit f jib	CCONJ PRON VERB PRON VERB PRON NOUN ADP NOUN
weli we li 3andou arde ou ma3andouche permis de construire !!!!!!? vive algerie inchallah algerie rabha zambia be 4 / 0 wakha iala3bou htta fe trab farahtona allah m3akoum	_ CCONJ PRON PRON NOUN CCONJ ADP NOUN ADP VERB PUNCT VERB PROPN INTJ PROPN ADJ PROPN ADP NOUN PUNCT NOUN INTJ VERB ADV ADP NOUN VERB PROPN PRON
darolhom bero3b be ro3b ta3 3antar bno chadad	VERB _ ADP NOUN ADP PROPN PROPN PROPN
momkin en 2060 barkana balkadb b al kadb jalma noud at3amar fako fako fako	ADJ ADP NUM VERB _ ADP DET NOUN ADV VERB VERB VERB VERB VERB
yestahl kol khir li yat3ab yanal 123 viva la algerie	VERB DET NOUN PRON VERB VERB INTJ VERB DET PROPN
nal3ab m3a wat mieux que sad m3a hada benchikha rahet l'equipe l' equipe c bon	VERB ADP PROPN ADJ SCONJ PROPN ADP PRON PROPN VERB _ DET NOUN VERB ADJ
bravo les verts nchallah t3awdouha avec guambia	INTJ DET PROPN INTJ VERB ADP PROPN
saleme alikoum saleme ya chawechi ya bechicha fi khater djazair ou fi khater la jsbm koun seba3e ki babak ou zahina rebi ikoune me3ak in chalahe neheb nqouleke hadja ou hiya na3eref bli kader 3eliha besah ma tezidje tkheroudje bezaf 3ne mantiqa dyalek kima yelzemche el hale we in chalah tefouzou ya fawezi	NOUN PRON NOUN INTJ PROPN INTJ PROPN ADP NOUN PROPN CCONJ ADP NOUN DET PROPN VERB ADJ SCONJ NOUN CCONJ ADJ PROPN VERB PRON INTJ X VERB VERB NOUN CCONJ PRON VERB SCONJ ADJ PRON CCONJ ADV VERB VERB ADV ADP NOUN PRON SCONJ VERB DET NOUN CCONJ INTJ X VERB INTJ PROPN
salut hadi mahiche 3taba mais 3a9aba w3lahe hada kamle 3lihome trop charge w rabi m3ana fi bac 2011	INTJ PRON NOUN NOUN CCONJ NOUN ADV PRON ADV PRON ADV ADJ CCONJ PROPN PRON ADP NOUN NUM
incha allah nerebhou zkara et nrouhou el kaas el 3alemamine	INTJ X VERB ADV CCONJ VERB DET NOUN DET NOUN
yweli tzeus bla b la force ta3 maciste	VERB PROPN _ ADP DET NOUN ADP PROPN
fi blastl ktila ana ncombati belktiba be l katiba be l katiba	ADP NOUN NOUN PRON VERB _ ADP DET NOUN ADP DET NOUN
les juifs ye3arfou kifach yrabhou el jnass machi kim le3rab le 3rab !!	DET ADJ VERB ADV VERB DET NOUN PART ADP _ DET NOUN PUNCT
raki lkiti win tahki ton histoire ya ilham rani krib ndir kima ton ex et augmente le célibat en algérie augmente mais lazam y3ass rouhou c'est c' est une maroccaine	VERB VERB PRON VERB DET NOUN INTJ PROPN VERB ADJ VERB ADP DET ADJ CCONJ VERB DET NOUN ADP PROPN VERB CCONJ VERB VERB NOUN _ PRON VERB DET NOUN
tres bien ya 5adra w rabi m3akom w el jelya etounsia e tounsia fi japon t7ayekom	ADV ADJ INTJ PROPN CCONJ PROPN PRON CCONJ DET NOUN _ DET ADJ ADP PROPN VERB
lbare7 fra7na min t3adlet dzayer o ntouma fre7tou min t7adelna 7na hhhh mais hadi hia lkooora l kooora nshallah f lmatch l match nta3 maroc vs algerie tkoun fiha faire play o se7a ftourkom	ADV VERB ADP NOUN PROPN CCONJ PRON VERB ADP VERB PRON INTJ CCONJ DET PRON _ DET NOUN INTJ ADP _ DET NOUN ADP PROPN ADP PROPN VERB PRON ADJ NOUN CCONJ NOUN NOUN
salam 3alikom vraiment khoya rabi yehssen 3awnek mais loukane lhagte tema khir	INTJ PRON ADV NOUN PROPN VERB NOUN CCONJ VERB VERB ADV ADJ
aya les jeunes efferhou w farhouna m3akom rebi yensorkom w eykoun m3akom	VERB DET NOUN VERB CCONJ VERB PRON PROPN VERB CCONJ VERB PRON
we nchallah tout les algeria m3aya viiiiiiiiiiiiiive sa3dan	CCONJ INTJ ADJ DET NOUN PRON VERB PROPN
3awdouha ya les jeunes	VERB INTJ DET NOUN
rabi m3ak ya khouya walah sa ma m a fais de la peine et jai j ai meme des larmes au yeux ahkame fi rabi ou rabi idjibe chfaa in chalahh je te souhaite bq de courage	PROPN PRON INTJ NOUN INTJ PRON _ PRON AUX VERB ADP DET NOUN CCONJ _ PRON VERB ADV DET NOUN ADP NOUN NOUN ADP PROPN CCONJ PROPN VERB NOUN INTJ X PRON PRON VERB ADV ADP NOUN
Ntaba3 el swared w nrouh nbi3 el zetla makra	VERB DET NOUN CCONJ VERB VERB DET NOUN ADJ
hahahahah hlef belik maymedech 300 millions medelhoum 297 millions ;hada hak la3cha l a3cha dyal les joueurs hahahahah meskine ma3andouche swaredh	INTJ VERB PRON VERB NUM NOUN VERB NUM NOUN PRON PRON _ DET NOUN ADP DET NOUN INTJ ADJ ADP NOUN
hadek wach khass wach ganite belhadj wlid el khadra ou mouhaaallll aykoun wlid katar ou mayafhamch el 3arbia ou mazidouch nassam3ou had laklammmmmmm la klammmmmmm	PRON PRON VERB PRON VERB PROPN NOUN DET PROPN CCONJ ADJ VERB NOUN PROPN CCONJ VERB DET ADJ CCONJ VERB VERB PRON _ DET NOUN
pour le no 7 mcha l'kheir l' kheir m3a echeikh e cheikh wa la kheir fi cheikha	ADP DET NOUN NUM VERB _ DET NOUN ADP _ DET PROPN CCONJ PART ADJ ADP PROPN
barakalahe barak alahe fik ya rayece mais ncite el khidma elwataniya el wataniya 3ame wa nace bazafe	_ VERB PROPN PRON INTJ NOUN CCONJ VERB DET NOUN _ DET ADJ NOUN CCONJ NOUN ADV
vive lalgerie l algerie m3ak ya khadra nchallah	VERB _ DET PROPN PRON INTJ PROPN INTJ
lmara l mara dia stylo ydir massacre à la transoneuse	_ DET NOUN PRON NOUN VERB NOUN ADP DET NOUN
ana m3ak ya saheb ta3lik nimiro 4 ana kbayli w anhab jsk mon cour + usmh bassah nakrah mco	PRON PRON INTJ NOUN NOUN NOUN NUM PRON ADJ CCONJ VERB PROPN DET NOUN ADV PROPN CCONJ VERB PROPN
ya rabe yechfik o ymadek bikowa bi kowa akthar meli anta fiha rabi m3a essabrine e ssabrine o rahime b3ibado b b3ibado akthare men rahmate el ome 3la wladha natlobe men rabi yechfik oyahafdak o oyahafdak hada ibtilae men 3ando koune sabare o rabi yfarraje 3lik o matafkadche el amale el 3ilme dima yetaware o matedri inchallahe ykoune echiffae e chiffae biidni bi idni allahe rabi m3ake	INTJ PROPN VERB CCONJ VERB _ ADP NOUN ADV PRON PRON PRON PROPN ADP _ DET NOUN CCONJ ADJ _ ADP NOUN ADV ADP NOUN DET NOUN ADP NOUN VERB ADP PROPN VERB _ CCONJ VERB PRON NOUN ADP PRON VERB ADJ CCONJ PROPN VERB PRON CCONJ VERB DET NOUN DET NOUN ADV VERB CCONJ VERB INTJ VERB _ DET NOUN _ ADP NOUN PROPN PROPN PRON
Manbi3ch be tarf 3la jal 100 elf ta3 sqata	VERB ADP NOUN ADP NOUN NOUN NOUN ADP NOUN
hier j'été j' été entrain en train de chercher la chaine arabe qui diffuse le match de l'OM l' OM pour voir ZIANI alors j'ai j' ai trouvé que une chaine libienne diffuse le match de LYON walah 3aybe 3likoum ya les tsimou rouhkoum responsable wa nahar kamel wa ntouma tzoukhou 3lina derna wa derna LIBYA hacha sam3in diffuse championnat francaise et en direct et nous un match de l'equipe l' equipe algerienne on peut pas le voir walah tdjouz fikoum lektila l ektila 3ayb 3ayb 3ayb 3likoum et walah matahachemou wadjahkoum sehih	ADV _ PRON VERB _ ADP ADP ADP VERB DET NOUN ADJ PRON VERB DET NOUN ADP _ DET PROPN ADP VERB PROPN ADV _ PRON AUX VERB ADV DET NOUN ADJ VERB DET NOUN ADP PROPN INTJ NOUN PRON INTJ PRON VERB NOUN ADJ CCONJ NOUN ADJ CCONJ PRON VERB PRON VERB CCONJ VERB PROPN NOUN ADJ VERB NOUN ADJ CCONJ ADP NOUN CCONJ PRON DET NOUN ADP _ DET NOUN ADJ PRON VERB ADV PRON VERB INTJ VERB PRON _ DET NOUN NOUN NOUN NOUN PRON CCONJ INTJ VERB NOUN ADJ
les algériens kamale m3akome antoma bark ali kderto twahdo les algériens	DET NOUN ADV PRON PRON ADV PRON VERB VERB DET NOUN
vive l'algérie l' algérie 5 fi 3aynin el hassadine	VERB _ DET PROPN NUM ADP NOUN DET ADJ
ya wdiii da3ara raha par tt felcentre f el centre ville tchoufel tchouf el 3jeb elmou3ajeb el mou3ajeb nes lebsaa raha telbess el3raaa el 3raaa	INTJ NOUN NOUN VERB ADP X _ ADP DET NOUN NOUN _ VERB DET NOUN _ DET NOUN NOUN ADJ VERB VERB _ DET NOUN
douhm l'sahra l' sahra yflhou bah y3arfou kimt el jzayer	VERB _ DET NOUN VERB ADP VERB SCONJ DET PROPN
assalamo as salamo 3alikom je suis la pour passer 1n grande salut pour nos joueur soublie s oublie sur tout pa matmoure 40 le mieure joueure pour mon opinion w nchallah narb7o zambie 2 ou 3 on fin nas l7rakta l 7rakta kamel m3akom kom tout les algeriens far7ona nchallah w takabala allho siamana wa siyamakom w asalamo a salamo 3alaykom w ra7mato allahi wa barakatoho	_ DET INTJ PRON PRON VERB ADV ADP VERB DET ADJ NOUN ADP DET NOUN _ PRON VERB ADV X ADV PROPN NUM DET ADJ NOUN ADP PRON NOUN CCONJ INTJ VERB PROPN NUM CCONJ NUM ADV X NOUN _ DET ADJ ADJ PRON SCONJ ADJ DET NOUN VERB INTJ CCONJ VERB PROPN NOUN CCONJ NOUN CCONJ _ DET INTJ PRON CCONJ NOUN PROPN CCONJ NOUN
lazem yebka yet3adab fi 7yatou kima 3adab a nas w nchalah yzid yet3adab fi jahanama m3a abou jahle	VERB VERB VERB ADP NOUN ADP VERB DET NOUN CCONJ INTJ VERB VERB ADP NOUN ADP PROPN PROPN
bien jouie bougara natmanalak ahsan la3ib fa al3alam al 3alam	ADV VERB PROPN VERB ADJ NOUN ADP _ DET NOUN
ma 3andna ni les acteurs ni les producteurs	PART PRON ADV DET NOUN ADV DET NOUN
3ayechtini f'doute fi doute	VERB _ ADP NOUN
